: [Well, in, in, in]
,: [the]
-: [I, but, well, he, and, like, and, the, and, and, in, and, let, and, have, 7, and, the, Im, and, the, thats, losers, not, will, diplomatic, toward, the, and, the, and, to, all, it, and, I, a, was, were, and, there, and, their, we, you, President, that, so, to, and, develop, I, he, and, you, he, Steve, Ill, of, do, because, and, shes, do, but, 0,0., the, no, listen, never, in, 3]
.: [The, Wasnt]
/1: [to, the]
0: [very, US-designated, Muslim, people, years, cents, judges, days, states]
0,0: [hours]
0,0.: [When]
0.: [So, That]
000: [brand]
01: [America, They]
04,0: [jobs]
06: [election]
0page: [decision]
0th: [I, And]
0year: [period]
1: [why, trillion, Republicans]
1%: [Your]
1th: [-, attacks, And, 01]
1thhour: [rule]
2: [years, trillion]
3: [years, percent, percent]
4: [years, my]
42: [billion, billion]
47: [Youre]
5: [tax, million]
5,0: [Poles]
500: [people]
6: [years, years]
6.: [But]
7: [years]
7,: [0.]
7.: [You]
7.Ä: [For, And]
8: [years]
81: [Now]
87: [But]
9: [years]
90: [in]
93: [And]
94: [the, Jerusalem, He]
99: [you, and]
9th: [Boy]
A: [great, great, disaster, star, hasty, core, vibrant, million, strong, strong, lot, word]
Abe: [was]
Abraham: [Lincoln]
Access: [Pipelines]
Act: [Was]
Administration: [people]
Afghan: [government, military, people, security, government]
Afghanistan: [and, the, and, in, First, because, the, and, and, and, and, and, but, to, It, but, especially, These, and, and, has, is, or, must, enlisted, and]
Afghans: [will]
After: [many]
Again: [All]
Agata: [have]
Agency: [Hell]
Air: [Force, Force]
All: [right, the, the, of, of]
Alliance: [Poland]
Also: [time, my]
Amazing: [I]
Amendment: [governors, So, We, Thank, So, he, but, freedoms, For]
America: [first, Great, we, Thank, great, as, And, Youre, if, including, totally, strong, proud, safe, great, Thank, hurts, requires, hastily, and, and, will, is, commits, before, will, will, and, from, Thank, loves, loves, is, and, and, Our, Thank, You, The, first, Scouts, great, great, great, Were, turns, strong, Youre, great, is, Go]
American: [patriot, patriots, energy, workers, jobs, and, We, people, politics, people, people, nation, independence, flag, patriots, family, military, people, history, peoples, strategy, power, people, armed, might, military, people, lives, interests, Polish, patriots, forces, people, success, success, values, values, patriot, aircraft, power, patriots, hearts, Boy, tradition, Thank, than]
Americans: [in, stood, And, so, have, listening, arms, let, Poland, Poles, will, know, strong, As, Instead, and]
Americas: [core, interests, enemies, greatest, commitment, part, sportsmen, borders]
Amid: [that]
An: [energy]
And: [its, the, if, yes, perhaps, were, I, to, to, I, I, by, believe, every, harder, youve, if, in, very, by, just, I, now, now, by, what, I, I, so, we, Ive, so, you, heres, I, we, what, were, theres, they, it, I, we, now, we, to, it, we, when, as, that, this, may, to, we, you, so, when, with, you, we, if, we, above, if, for, let, for, the, the, to, today, our, God, if, instead, when, just, I, believe, so, by, a, a, by, Rick, were, very, Ill, hes, hopefully, another, some, great, Im, you, well, look, each, he, hed, he, he, after, they, I, it, I, I, I, I, he, I, he, I, if, remember, at, they, you, we, by, we, Id, Ill, Ill, by, by, we, as, if, never, I, by, it, I, its, you, to, remember, we, she, today, I, I, like, its, its, I, we, by, I, also, we, Attorney, hes, you, by]
Andrew: [Jackson]
Another: [fundamental, critical]
Antonin: [Scalia]
Anybody: [who, ever]
Anywhere: [from]
April: [4]
Arabia: [three, I]
Are: [they]
Arizona: [Intel, up]
Arlington: [National]
Armed: [Forces]
Army: [the]
Article: [,]
As: [your, we, a, I, a, we, the, I, long, a, we, the, members]
Asia: [But, My, but, will, strategy, and]
Atlanta: [and]
Atlantic: [our]
Attorney: [General, General, General]
August: [of]
Avenue: [In, was, Every, That, The, passage, crossing, But]
Barcelona: [to]
Basically: [people]
Be: [able]
Because: [you, when, as, youre, when, theyre, believe]
Being: [interviewed]
Believe: [me]
Bernardino: [Hundreds]
Between: [its]
Big: [Sky, sports]
Billions: [of]
Bishop: [Michael]
Bless: [you, our, You, the]
Boeing: [and, in, its, in]
Boston: [to]
Bowls: [and]
Boy: [Scout, you, Scouts, Scouts, Scouts, Scouts, Scouts, Scouts, Scouts, Scout, Scouts, Scout, Scouts, Scouts, Scouts, Scouts, Scouts, Scouts, Scouts, Scouts, Scouts, Scouts, Scouts, Scouts, Scouts, Scouts, Scout]
Brexit: [Look, Much]
Bring: [them]
British: [are, are, are, and]
Brussels: [You]
Bryant: [of, is]
But: [we, we, we, were, despite, we, before, we, all, one, to, Pakistan, that, we, strategically, while, there, today, they, just, billions, I, looking, its, here, in, well, what, he, I, you, the, when, when, you, then, we, the, the, if, this, it, earlier, theyd, you, I, we, thats, you, listen]
Buy: [American]
By: [theyre, the, the, the, following, the, the, the, the, the, honoring]
CNN: [poll]
Cabinet: [General, and]
California: [Illinois]
Camp: [David]
Can: [you, you, you]
Capito: [to]
Captain: [Levi, said, Prestons]
Carolina: [We, We, South, Pennsylvania]
Cemetery: [There]
Central: [Europe]
Chairman: [Ralph]
Change: [like]
Charlton: [Heston, And, he]
Chicago: [Hundreds, and]
Chopin: [Saint]
Chris: [for, have]
Christmas: [again, Theyve, again]
Chrysler: [are]
City: [And]
Coast: [And, And, and]
College: [Popular, you]
Colonel: [Duggan]
Come: [here, here, on, on, on, on, here, here, here]
Concord: [Was, each]
Conditions: [on]
Constitution: [not, of, and, Justice, I]
Control: [of]
Copernicus: [Ä]
Country: [in]
Court: [For]
Croatia: [on]
Cruz: [-]
DC: [Ive, does, youve]
Dakota: [Access]
David: [Perdue, with]
DeMint: [Its]
Deal: [of]
Defense: [Mattis, and]
Democrats: [and, to, Ä, were, not, because, should, want, to, will, are, coming]
Department: [of, of, of]
Deputy: [Secretary]
Despite: [every]
Director: [sic,]
Do: [we, we, we, you, you, you, we]
Does: [that]
Dog: [Mattis]
Doing: [a]
Donald: [Trump", I, Trump, Trump]
Dont: [even, even, even, worry, even, even]
Dr: [Price]
Duda: [and, and]
Duggan: [Most]
Dunford: [Deputy]
During: [a]
Each: [of, of]
Eagle: [Scout, Scout, Scout]
Earth: [The, But, Many, but]
East: [that, Coast, Coast, Coast]
Election: [came]
Electoral: [College, College]
Energy: [Rick]
Environmental: [Protection]
Erasing: [national]
Europe: [We, as, but, Your, Ä, endured, still, that, and, is, is, have, value, will, must, must]
European: [conquest]
Every: [day, night, day]
Everything: [we]
Everywhere: [it]
F3: [fighter]
F3.: [Youve]
Fake: [media, news]
Federalist: [peopleÄwhere]
Fiat: [Chrysler]
Fifth: [Avenue]
Finally: [my, on, they, -]
Firemen: [police]
First: [our, Lady, Lady]
Florida: [Where, My, We, North]
For: [those, the, the, its, two, Americans, Americas, more, months, the, too, the]
Force: [One, One]
Forces: [Thank]
Ford: [General, Everywhere, today]
Forget: [about]
Fort: [Myer]
Forum: [since]
France: [and]
Frankly: [I]
Freedom: [is, is]
Friday: [at]
From: [now, the]
General: [Kelly, Kelly, Motors, now, Dunford, Election, number, and, Sessions, Kelly]
Generations: [of]
George: [Washington]
Georgia: [And, .]
Gerald: [R, R]
German: [military]
Germany: [you, from]
Get: [mired, them, them]
Ghetto: [and, Uprising]
Go: [out]
God: [It, Bless, Bless, bless, bless, bless, The, bless, bless, And, We, Thank, Bless, bless, bless, bless, bless, and, are, put, bless, bless, Bless]
Godfearing: [farmers]
God‚ù: [In, Together]
Good: [guys, guys]
Gorsuch: [He, sits]
Governor: [Scott, Scott, Bryant, Bryant, Deal]
Great: [Again, guy, guy, guy, job, Id]
Greater: [than]
Greenwood: [Wow]
Greta: [That]
Guy: [was]
Handel: [on]
Have: [you]
He: [said, wont, will, said, was, can, or, comes, will, makes, was, better, better, better, better, sounds, -, so, got, went, came, had, said, goes, lost, was, was, has]
Heading: [up]
Health: [and]
Hell: [do]
Heres: [the]
Heritage: [And, Jim]
Hes: [in, incredible, respected, got, going, going, going]
Heston: [How]
Hey: [what]
Hi: [folks]
His: [name, education, writings]
Hollywood: [show]
Holocaust: [the]
Home: [Army]
Homeland: [Security, Security]
Hop: [over]
Hopefully: [theyll]
Horrible: [As]
House: [is, It, weve, were, No]
How: [good, did]
However: [our]
Human: [Services]
Hundreds: [of, of, of]
I: [said, see, loved, really, will, can, know, greatly, can, will, didnt, thought, truly, am, want, want, will, promise, want, also, can, will, will, can, hear, hear, promise, will, promise, and, can, know, speak, mean, said, got, followed, was, said, said, said, put, can, said, said, refuse, refuse, got, probably, got, got, told, got, also, said, can, said, negotiated, took, know, actually, can, dont, saw, just, love, just, have, see, wouldnt, see, see, told, want, want, said, was, said, was, found, understand, thought, would, dont, dont, guess, listened, disagree, disagree, just, think, want, was, have, have, just, said, said, promise, am, provide, want, am, share, also, directed, like, studied, arrived, concluded, became, was, fully, was, outlined, will, have, have, took, will, was, mean, have, congratulate, am, can, am, am, stand, the, called, would, must, declare, am, am, said, want, said, especially, go, see, see, said, see, can, love, really, rely, wonder, can, got, will, cant, hope, love, dont, going, do, do, was, wont, tell, tell, would, saw, was, got, was, go, see, recognize, see, immediately, immediately, wanted, went, said, know", said, knew, said, lost, lost, tell, never, thought, always, see, do, love, have, told, went, went, kept, said, have, traveled, want, promise, just, want, think, know, speak, say, remember, was, really, love, heard, have, can, am, was, am, want, know, promised, am, can, think, think, spoke, promised, would, even, would, want, want, mean, kept, have]
II: [Poland, the]
IIs: [sermon]
ISIS: [I, and, The, to, including, crushing]
Id: [much, leave, say, also]
If: [you, you, left, anyone, you, you]
Ill: [tell, check, tell, tell, say, get, tell, tell, tell, tell]
Illinois: [you]
Im: [also, here, the, the, coming, not, only, not, wrong, a, a, in, especially, waving, honored, not, in, Donald, talking, shocked]
In: [America, fact, Arizona, fact, fact, Afghanistan, the, this, abiding, this, every, those, 90, the, those, every, fact, August, fact, fact, other, life, life, the, other, fact]
Incredible: [people, Thats]
Independence: [and]
India: [are, -, makes]
Indiana: [but, scouts]
Indias: [important]
IndoPacific: [region]
Initiative: [To, Thank]
Instead: [of, we, one, we]
Intel: [great]
Interior: [Ryan, Ryan]
Iowa: [and]
Iran: [Ä]
Iraq: [As, Third, Since, combating]
Is: [Leo]
Islamic: [terrorists, terrorist, terrorism]
Isnt: [that, that]
It: [was, was, will, was, meant, meant, will, cannot, was, doesnt, undermines, belongs, has, is, is, is, was, was, was, looks, didnt, was, was, may]
Its: [that, time, time, so, now, what, not, sweeping, going, very, a, become, a, sweeping, sweeping, now, a, amazing, time, incredible, great, just, the, too, been, called, not, not, about]
Ive: [already, taken, directed, ordered, ordered, taken, also, already, nominated, heard, said, been, noticed, noticed, known, known, been, appointed]
Jackson: [and]
Jamboree: [wow, Chairman, was, And, -]
January: [0th]
Japan: [Prime, is]
Jeff: [Sessions]
Jefferson: [Andrew, said]
Jerusalem: [Avenue, Avenue, Avenue, Avenue, Avenue, Avenue, Avenue]
Jewish: [population, citizens]
Jim: [DeMint]
Jobs: [are]
John: [Paul, Paul, Paul, Kelly]
Judge: [Neil]
June: [4, nd, 0th]
Just: [steps, as, like]
Justice: [to, to, Scalia, Antonin]
JusticeÄand: [he]
Karen: [Handel, Also]
Katyn: [forest]
Keeping: [our]
Kelly: [how, now, hes, Secretary, who, is]
Keystone: [and]
Kozal: [said]
Koõciuszko: [The]
LaPierre: [for]
Lady: [Melania, Agata]
Last: [year]
Leadership: [Forum]
Lech: [Walesa]
Lee: [Greenwood, I, No]
Lees: [anthem]
Leo: [Is, around]
Less: [regulation]
Let: [Trump, him, us, us, them, your]
Lets: [also, see]
Levi: [Preston]
Levitt: [You, up, of, Im, how]
Levittown: [And, and]
Lexington: [alarm]
Lincoln: [and]
Lockheed: [Martin]
Look: [at, at, at, at, at, at, at, at]
Lords: [Prayer]
Love: [for]
Loyalty: [to]
MS1.: [Get]
MS1?: [Its]
MS1‚îyou: [know]
Maine: [four]
Make: [America]
Man: [this]
Many: [years, of, of, many]
Martin: [who]
Mattis: [to, and]
May: [God, God]
Maybe: [Im]
Melania: [was, Thank, That]
Merry: [Christmas, Christmas, Christmas]
Mexico: [Why]
Michael: [Kozal, Surbaugh]
Michigan: [came, and, Theyre, How]
Michigan": [They]
Micromanagement: [from]
Mike: [Pence, was]
Military: [power]
Millions: [of]
Minister: [of, Abe, Szydlo]
Miracle: [of]
Mississippi: [What]
Montana: [Pretty]
Most: [especially]
Mostly: [young]
Mosul: [in]
Motors: [Fiat]
Movement: [has]
Mr: [President, Levitt, Levitt]
Much: [smaller]
Muslim: [nations]
My: [second, administration, administration, original, sincere]
Myer: [and]
NAFTA: [and]
NATO: [fan, many, allies, Alliance, finally, In, countries]
NRA: [conference, I, and, You, I, that, Leadership, protects, to, because, know]
NRAs: [earliest]
National: [Cemetery, Jamboree]
Navy: [Its]
Nazi: [Germany, and, snipers]
Nazis: [systematically, ruthlessly]
Neil: [Gorsuch]
Never: [ever, quit, ever]
New: [circumstances, York, York, York, planes]
Next: [came]
Nice: [Take, guy]
No: [I, no, wonder, longer, longer, one, partnership, better, one, longer, longer]
No": [the]
Nobody: [talks, was]
None: [of]
Norfolk: [Virginia]
North: [Carolina, Carolina]
Not: [going, one, one, far, good, well, well, going, 7,, pleasant]
Nothing: [changes, changes, to]
November: [th, th, th]
Now: [we, you, is, we, among, with, we]
Nowhere: [is]
OK: [Because]
Obama: [They, ÄHe, and, ever]
Obamacare: [It, remember, and, doesnt, thats, we]
Obviously: [where]
Of: [course]
Office: [in]
Oh: [he]
Ohio: [Theyre, and]
Okay: [Nothing, Thats, So]
On: [the, behalf, their, his]
One: [Can, project, of, destiny, hundred, percent, vote]
Only: [one]
Or: [theyre]
Other: [than, than]
Otherwise: [it, Ill]
Our: [military, veterans, veterans, system, heroes, citizens, soldiers, militaries, troops, patience, actions, soldiers, two, adversaries, citizens, own, freedom, values, people, stock, nation, police]
Oval: [Office]
Pakistan: [-, often, and, Americas, We, has, has, has, billions, to]
Pakistani: [people]
Pakistans: [safe]
Paris: [Weve]
Partnership: [TPP]
Patriot: [air]
Paul: [Revere, II, IIs, II]
Pence: [Secretary, -]
Pennsylvania: [We, all]
People: [want]
Perdue: [-]
Perhaps: [some, maam]
Perry: [of]
Persevere: [Never]
Pipelines: [Anywhere]
Please: [be]
Pocahontas: [remember]
Poland: [and, that, is, and, is, suffered, could, lives, prospers, prevails, is, has, is, stopped, rose, and, and, could, would, once, the, prevailed, will, has, is, we, Ä, for, I, Thank, And, once, is, could]
Polands: [Jewish]
Poles: [have, died, gathered, sang, reasserted, the, and, put, dug, as, never, Ä]
Polish: [people, nation, people, British, people, spirit, heroes, people, people, people, character, martyr, Pope, men, people, people, people, experience, Home, fighters, woman, people, people]
PolishAmericans: [have]
Pope: [that, John, John]
Popular: [vote]
Prayer: [but]
President: [I, finds, may, Pence, of, I, Duda, Lech, Duda, I, of, and, Randall, Trump, Trump, Obama, Gerald, the, of, to, can]
Preston: [aged]
Prestons: [words]
Pretty: [good]
Price: [is, still]
Prime: [Minister, Minister, Minister]
Protection: [Agency]
Pruitt: [was]
PuÇaski: [and]
Qaeda: [would]
R: [Ford, Ford]
Ralph: [de]
Randall: [Stephenson]
Reagan: [And, in]
Really: [they]
Redcoats: [was]
Remember: [they, your, that, that, they]
Republican: [But]
Republicans: [are, So, I, are, running, have]
Retribution: [will]
Revere: [spread]
Rex: [Tillerson]
Rick: [Perry, told, thank, we]
Right: [Youve, ÄIf, I, So, Unbelievable, There]
Romanian: [soldiers]
Ronald: [Reagan, Reagan]
Ross: [-, who]
Russia: [to]
Ryan: [Zinke, Ryan, is, Secretary, Zinke, is]
Safety: [is]
Saint: [John]
San: [Bernardino]
Saudi: [Arabia, Arabia]
Say: [a]
Scalia: [His, I]
Scott: [of, Great, Pruitt]
Scout: [Jamboree, executive, he, and, from, from, oath, more, just, values, law, Its, I, oath, -, Thank]
Scouts: [can, Right, of, President, you, No, believe, every, we, Ten, Can, lead, And, become, today", so, but, right, you, have, because, never, name, celebrate, placing, have, Let, over, God]
Seas: [Initiative, Initiative]
Second: [Amendment, Amendment, the, Amendment, Amendment, Amendment, Amendment, Amendment, Amendment]
Secret: [Service]
Secretary: [Kelly, He, ÄMad, of, Shanahan, of, of, of, of, of, Tom, of, Kelly]
Security: [and, Director]
Sell: [it]
Senate: [Democrats, That, Democrats, Democrats]
Senator: [David, Ted, Capito]
September: [1th, 1th, 1th, 1th]
Series: [and]
Service: [was]
Services: [And]
Sessions: [And, is]
Seven: [years]
Shanahan: [and]
She: [was]
Shes: [totally, running]
Should: [I, I]
Simple: [question]
Since: [the, the, my, taking]
Sit: [back]
Sky: [Country]
Smart: [cookies]
So: [let, smoothly, I, think, theyre, the, were, hes, we, you, the, you, I, essentially, and, basically, unfair, well, theyre, we, were, were, lets, we, I, it, we, together, thank, Rick, thats, we, whatever, thats, look, he, they, I, youll, as, when, -, I, I, get, get, Lee, we, they, they, why]
Sold: [his]
Solidarity: [Movement]
Some: [of]
Someday: [after]
Something: [this]
South: [Asia, Asia, Asia, Asia, Asia, Asia, or, Carolina, Carolina]
Soviet: [army, Union, armies, armed]
Square: [for]
Stamp: [Act]
State: [Tillerson, Rex]
States: [We, -, of, of, and, Right, of, military, So, to, We, and, of, has, and, and, has, the, of, But, has, Mike, Navy, of, standing, Supreme]
StatesÄ: [Ä, Ä]
Stephenson: [chief]
Steve: [Ross, Ross]
Stretching: [back]
Super: [Bowls]
Supreme: [Court]
Surbaugh: [Jamboree]
Sweden: [Sweden, who, They]
Syria: [and, and]
Szydlo: [a]
TPP: [we]
TV: [just]
Take: [a, a]
Taliban: [in, in, and, from]
Tax: [Was]
Tea: [Tax]
Ted: [Cruz]
Ten: [members, Secretary]
Tens: [the]
Terrorists: [who, take]
Texas: [an]
Thank: [you, you, you, you, you, you, you, you, you, you, you, you, you, you, you, you, you, you, you, you, you, you, you, you, you, you, you, you, you, you, you, you, you, you, you, you, you, you, you, you, you, you, you, you, you, you, you, you, you, you]
Thanks: [to]
That: [I, is, I, I, took, was, didnt, didnt, is, is, was, is, is, is, is, narrow, mortality, was, is, was, includes, was, is]
Thats: [an, not, good, going, going, my, okay, why, been, why, so, trouble, tough, a, some, an, a]
The: [British, most, dishonest, White, gang, fact, people, miners, lawyers, pipe, Air, price, order, media, media, reason, Democrats, nation, socalled, tired, men, soldier, young, men, vacuum, threat, next, Pakistani, stronger, government, American, United, Poles, triumph, signs, same, story, Polish, people, West, nations, world, people, fundamental, German, enemy, Jerusalem, memories, press, United, values, Scouts, vice, first, fake, answer, word, car, polls, stock, election, NRA, eightyear, Federalist, last, credit]
Their: [so, message, soldiers]
Then: [9, the]
There: [will, was, was, is, is, are]
Theres: [a, no, nothing]
These: [are, are, are, killers, soldiers]
They: [know, are, dont, are, dont, have, will, said, wont, would, may, are, stood, started, came, didnt, werent, were, were, took, were, got, have, transcend, take, are, deserve, are, are, volunteered, loved, watched, tried, must, did, found, are, are, ran, dont, dont, better, forgot, go, fought, were, really, wont]
Theyd: [say]
Theyre: [not, going, coming, seven, going, interviewing, going, saying, having, not, not, all, going, coming, coming, starting, fake, trying]
Theyve: [become, got, been, been, been]
Things: [that]
Third: [and]
This: [is, is, was, was, guy, guy, guy, is, movement, will, is, principled, is, is, monument, continent, danger, great, is, was, is]
Thomas: [Jefferson, Jefferson]
Those: [days, are, heroes, are]
Three: [judges, Seas, Seas]
Thrilled: [And]
Through: [their, four, all, scouting]
Tillerson: [members, is]
Time: [Warner]
To: [defend, defend, pursue, rebuild, fix, bring, ensure, reform, the, meet, those]
Today: [0, the, the]
Together: [with]
Tom: [Price, youre]
Tonight: [we]
TransPacific: [Partnership]
Tremendous: [disadvantage]
Trump: [That, Let, do, spoke, spoke, They, administration, has, has, he]
Trump": [He]
Turn: [those]
Two: [days]
US: [service]
US-designated: [foreign]
USA‚ù: [You]
USS: [Gerald]
Ukraine: [and]
Ultimately: [it]
Unbelievable: [Unbelievable, And]
Under: [the, my, a]
Uniformed: [services]
Union: [from]
United: [States, States, States, States, States, StatesÄ, States, StatesÄ, States, States, States, States, States, States, States, States, States, States, States, States, States, States, States, States, States, States, States, States]
Uprising: [and, the, What, When, itself, alive, the, cry]
VA: [and]
Vega: [and]
Veterans: [Administration]
Vice: [President]
Victory: [Square]
Virginia: [who, We, by, to]
Vistula: [Poland]
Walesa: [so]
Want: [God‚ù]
War: [of, I]
Warner: [and]
Warsaw: [Uprising, where, Ghetto, Ghetto, Amid, Uprising, must, Ä, and, Uprising, The, Uprising]
Was: [it, it, it, that]
Washington: [or, and, DC, DC, and, DC, and, has]
Wasnt: [that]
Way: [back]
Wayne: [LaPierre, thank, and]
We: [need, need, spend, have, all, always, dont, are, must, are, are, are, will, dont, dont, believe, were, believe, are, got, know, will, will, did, did, dont, never, had, do, want, want, want, dont, dont, will, make, love, owe, are, are, have, need, dont, fight, dont, dont, dont, dont, want, are, share, are, will, will, will, send, cannot, cannot, must, need, must, will, are, are, are, can, recognize, have, appreciate, are, will, will, will, are, want, are, will, prevailed, must, must, will, are, are, welcome, salute, will, will, are, must, are, cannot, urge, must, are, write, pursue, celebrate, reward, strive, treasure, empower, put, challenge, seek, did, will, have, can, will, are, want, have, won, won, won, won, won, won, had, love, love, love, had, have, are, will, have, are, need]
Wear: [your]
Well: [build, be]
Were: [going, going, moving, going, going, going, going, still, very, standing, standing, going, stopping, stopping, going, going, going, going, going, going, going, not, giving, going, fighting, fighting, going, going, going, you, doing, going, doing]
West: [that, and, and, is, became, ultimately, has, was, does, will, Virginia, Virginia, Virginia]
Weve: [seen, just, directed, taken, got, got, allowed, come, also, also, already, already]
What: [a, did, great, we, exactly, youre, a, youve, youve, youve, fun]
Whats: [going]
When: [the, he, they, some, one, we, I, America, they, you, you, I, you, youre, natural, I]
Whenever: [somebody]
Where: [is, are, the, is, is]
Wheres: [West, Leo]
While: [we]
White: [House, House, House, House]
Who: [makes, is, is, would, thought]
Why: [they, did, did, is, are]
William: [Levitt, Levitt, Levitt]
Winners: [Ive]
Wisconsin: [came, now, hadnt, and, So, whoa"]
With: [our, your]
Within: [a]
Words: [are]
Working: [alongside]
World: [War, Series]
Wow: [Lees]
Yet: [through]
York: [City, were, California]
You: [want, want, want, want, want, want, want, want, want, know, might, saved, know, look, look, look, look, have, wait, take, look, saw, are, stood, were, see, God, set, set, want, are, know, know, learn, can, can, have, have, need, will, have, have, know, wont, know, dont, know, know, know, learn, pledge, should, inherit, are, will, are, know, have, met, know, need, see]
Youll: [get, have]
Your: [deductibles, nation, borders, oppressors, values, lives]
Youre: [not, seeing, going, all, Boy, one, ultimately, going, going, special, special]
Youve: [all, seen, seen, been, heard, all, heard]
Zinke: [is, eliminated]
a: [wall, wall, great, wonderful, lot, simple, gift, gift, great, ragtag, young, work, reminder, sovereign, free, state, state, month, great, movement, truly, room, better, big, newspaper‚ù, very, health, couple, great, much, disaster, level, level, country, 5, big, government, government, new, long, new, few, little, massive, 42, new, 42, lot, billion, terrific, favor, competing, plane, lot, disaster, new, new, great, big, whole, big, kiss, tiny, couple, big, hanger, firm, great, task, civil, plan, great, couple, court, judge, Ä, great, college, high, bad, lot, total, lot, court, look, look, mess, plan, great, veteran, five, foreign, fantastic, true, look, tragedy, 1, movement, level, NATO, new, tragic, few, special, nation, wound, single, wound, country, force, simple, country, foreign, comprehensive, plan, rapid, government, vacuum, result, terrorist, challenging, bad, problem, hasty, result, shift, timebased, successful, political, partner, friend, threat, valued, countrys, key, clear, clear, political, lasting, blank, lasting, simple, loved, very, profound, Poland, very, strong, single, land, people, future, symbol, special, fellowship, monument, people, nation, century, double, terrible, courage, strength, defeat, collapse, brutal, million, single, better, nation, lawless, cruel, strong, leading, Europe, blessing, blessing, historic, civilization, lack, strong, result, commitment, commitment, very, narrow, trench, barricade, few, constant, tremendous, lot, record, record, great, lifechanging, good, Boy, good, Scout, lot, lot, lot, fantastic, little, lot, great, chance, tremendous, Scout, great, Scout, good, scout, roaring, mountain, merit, certain, lot, small, Scout, nice, question, Jamboree, story, man, very, home, lot, tremendous, long, tremendous, big, very, very, big, big, 0year, lot, few, lot, cocktail, great, lot, hundred, little, book, tape, Scout, shot, little, good, good, good, beautiful, day, tremendous, minute, Republican, daily, great, century, symbol, noble, very, great, Boy, fantastic, friend, lot, long, great, big, historic, truly, great, tremendous, great, lot, lot, feeling, big, really, big, tough, long, crashing, true, long, giant, great, justice, list, new, long, bad, President, really, really, man, long, proSecondAmendment, great, man, 3, wall, wall]
abiding: [by]
ability: [to, to, and]
able: [to, to, to]
abolish: [the]
about: [it, it, it, the, our, our, believe, the, Obamacare, it, to, that, it, it, the, him, anything, him, because, and, that, those, so, on, but, tonight, Americas, numbers, Pakistans, the, Jerusalem, 0, 500, with, success, how, You, politics, building, picking, a, success, how, it, the, the, the, Boy, it, that, that, that, very, MS1?, time, it, it]
aboutÄwe: [remember]
above: [it, all, all]
abroad: [We, deserve, We]
absolutely: [perfect, yes]
accept: [those]
accepted: [Theyre]
access: [to, to]
accomplished: [in]
according: [to, to]
accountable: [Were]
achieve: [an, a, an, your, your, the]
achieved: [total, recordbreaking, the]
achievement: [that]
achieves: [victory]
acknowledge: [the]
acquiring: [from]
across: [the, our, the, the, our, our, the, that, Jerusalem, Jerusalem, that, the, the, our, our]
acting: [in]
action: [to, to, to, Hes, Homeland]
actions: [against, and, that, are]
active: [in]
activism: [you]
activities: [Conditions, in]
acts: [Let]
actually: [Ä, two, think, wrong, achieved]
adapt: [our]
additional: [troop, money]
address: [the, the, such, the]
administration: [are, has, A, is, will, placed, many, has, youll, issued, will]
administrations: [ammunition]
admiration: [that]
admired: [by]
advance: [the]
advanced: [aircraft]
advantage: [of]
adventure: [every]
adventures: [in]
adversaries: [and, however]
advisers: [in]
affairs: [and]
after: [deportation, the, another, race, a, September, the, my, an, September, the, the, another, seven, mastering, about, lawabiding, lawabiding, the, them, the, the]
again: [Does, Every, Im, and, Jobs, Look, Ive, Believe, I, We, And, Greater, We, held, this, As, So, and, and, Then, and, and, Youre, And, And, Whats, when, folks, you, I]
against: [those, them, our, us, common, the, these, America, the, this, oppression, a, a, these, radical, the, common, someone, those, us, us]
aged: [1]
agencies: [be]
agenda: [and, is, In]
agents: [of]
ages: [This, Change]
aggression: [including]
ago: [It, and, though, America, In, it, Sold, I, in]
agree: [with, with]
ahead: [strongly]
aims: [to]
air: [and]
aircraft: [carrier, carrier]
airplane: [I]
airports: [and]
al: [Qaeda]
alQaeda: [preventing]
alarm: [-]
aliens: [or, into, or, as, any, and]
alive: [Between]
all: [But, over, of, Make, took, heard, about, up, Americans, time, had, about, their, across, over, of, of, over, over, here, aliens, over, have, Our, His, Americans, across, part, over, women, of, brothers, sisters, Americans, service, part, When, hurt, suffer, of, other, strategic, my, of, instruments, of, Americans, hope, civilization, you, around, of, new, of, we, members, to, fight, of, of, of, of, these, over, my, of, of, of, of, by, the, fairness, of, times, special, across, So, very, together, the, of, of, the, of, of, heard, agree, over, 0]
all": [And, And]
alliance: [of, to, is, of]
allies: [into, throughout, we, and, and, and, and, And]
allow: [radical, our]
allowed: [thousands, to]
allowing: [it]
alltime: [high]
allure: [of]
ally: [but]
almost: [nothing, anything]
alone: [will]
along: [with, with]
alongside: [his, our, us]
already: [displayed, starting, imposed, lifted, seeing, happening, with, seeing, seen, Theyre, seen]
alreadyÄ9: [daysÄbut]
also: [remember, time, requires, joined, here, want, which, got, directed, pushing, acknowledge, share, sheltered, expand, maximize, greatly, We, pleased, Thank, thank, symbols, confronted, why, on, here, learned, fake, thank, like, proud, all, from, taken, moved, members, know]
alternate: [sources]
always: [had, meant, be, of, protect, win, prevailed, remember, prevail, welcome, be, seek, formed, tell, kept, stand]
am: [here, here, here, thrilled, here, deeply, thrilled, thrilled, I, going, also, here]
amazing: [Were, He, young, how, I]
ambassador: [for]
amid: [machine]
ammunition: [on, ban]
among: [my, the, our, people, the]
amount: [of, of]
amounts: [being]
an: [easy, oath, more, hour, embarrassment, order, incredible, injustice, honorable, effective, everlasting, honorable, incredibly, old, example, easy, Eagle, Eagle, energy, achievement, unbelievable, unbelievable, alltime, incredible, American, Eagle, American, exciting, empty, 1thhour]
ancestors: [has]
ancient: [heroes]
and: [we, all, were, that, youll, you, billions, white, protecting, now, Senator, defend, that, bear, then, workers, we, my, govern, every, even, sovereign, bear, positive, God, theyre, theyre, Its, among, I, who, theyve, Abraham, many, called, their, false, they, we, most, independent, we, nothing, I, we, communities, drug, they, I, theyre, for, for, by, replaced, it, on, defend, a, wins, more, isnt, when, you, special, you, bringing, we, so, currency, really, the, that, it, I, a, fighting, weve, thats, hire, I, 2, getting, he, all, regulations, going, were, women, law, from, they, I, didnt, police, theyve, many, the, we, poisoning, Ive, it, then, safety, so, I, these, for, women, it, talk, talk, by, they, thousands, there, other, live, their, everybody, we, the, now, now, most, for, our, you, accountable, lifetime, has, obstruction, destruction, to, very, bring, to, beg, work, bridges, airports, tunnels, highways, railways, they, the, the, justice, we, we, to, trade, three, conflicts, real, protect, our, restore, opportunity, remove, innovation, distrust, cooperation, won, lost, shared, dreams, child, find, all, one, by, may, Colonel, women, every, abroad, prayers, lost, recovery, South, to, resolve, for, though, to, women, one, color, sacrifice, sisters, live, selfless, to, no, women, we, women, loyalty, skill, of, nobody, treasure, most, my, South, historically, from, generals, enduring, women, the, to, unacceptable, directed, shelter, al, mistakenly, bled, won, launch, finally, the, Pakistan, terror, India, troubling, South, making, very, intricate, in, the, extremely, children, our, exposing, criminals, predators, -, yes, we, Pakistan, we, materials, being, South, military, the, to, a, how, other, beyond, terrorists, extremism, those, billions, that, terrorists, officials, to, a, economic, we, development, security, the, rules, work, work, our, swiftly, expertise, frontline, with, criminal, chaos, Americans, powerful, expand, other, law, overwhelming, stopping, global, funding, partners, they, their, secure, build, define, partners, safer, progress, our, economic, real, American, fight, missile, we, what, love, died, they, we, enduring, in, every, that, the, everlasting, every, America, I, to, free, your, kindness, I, your, democratic, Romanian, I, commerce, its, I, your, brutal, occupied, its, villages, squares, Poland, overcame, peace, American, in, Iraq, independence, destiny, we, national, bled, died, Koõciuszko, a, who, the, who, only, the, the, the, Soviet, bloody, heroes, we, for, waited, children, a, the, your, one, children, they, the, how, wicked, your, free, they, to, Europe, maybe, we, to, extremism, Europe, their, their, any, love, extremism, we, who, challenge, cyberwarfare, on, elsewhere, its, Iran, to, in, wealth, regulations, pursue, the, sovereignty, to, tradition, weaken, our, enemies, our, the, customs, always, discover, cherish, protect, free, of, family, bureaucracy, share, as, you, you, the, they, confidence, we, independent, for, fair, billions, you, missile, we, be, get, the, destroy, the, strong, we, learn, west, to, south, the, destroyed, it, again, again, freedom, that, couriers‚ù, they, reinforcement, few, defend, play, that, every, our, demand, our, memory, its, for, to, all, uphold, the, we, the, troop, dad, skills, in, in, I, I, its, the, it, federal, on, healthy, Human, replace, Ive, you, they, traditions, perseverance, to, you, lead, you, go, dedicate, got, more, at, hed, sawdust, small, they, clean, he, then, he, bought, he, the, they, they, the, selling, the, they, he, sailing, all, other, he, he, he, in, he, he, discovered, he, I, theyre, I, talked, I, how, how, the, a, I, its, then, youre, youre, again, again, its, tedious, never, youre, the, the, that, won, we, we, I, we, all, millions, voted, that, weve, to, to, your, God, glory, taken, free, billions, billions, most, its, revered, strength, thousands, lived, the, stand, love, cherish, you, help, purpose, joy, you, if, be, they, go, show, for, shes, vote, hes, hes, vote, back, in, then, Ohio, all, World, boxing, it, that, youre, I, every, our, died, we, youre, youre, were, legislative, Chris, hard, hard, I, champion, your, their, loyal, publicly, thats, now, were, women, that, sheriffs, gang, we, cartels, justice, defending, his, destroying, stop]
angle: [After]
announce: [in]
announced: [it]
another: [with, country, major, Love, these, oppressive, Were, danger, thing, success]
answer: [is]
answered: [the]
anthem: [is]
any: [longer, longer, other, longer, aliens, class, class, restriction, further, capacity, region, nation, other, form, kind, cost, more, credit]
anybody: [and, who]
anymore: [Its, Were, I, We, Were, Theyre, folks, Thats]
anyone: [forgets]
anything: [about, else, about, Sit, like, I, And, You, you, about, about, to]
anywhere: [else, I, in, in, in, in, on, in]
apart: [and]
appellate: [court]
applaud: [Poland, Poland]
applause: [And]
applied: [force]
apply: [swift]
appointed: [people]
appointmentsÄand: [Ive]
appreciate: [Indias]
appreciated: [your]
approach: [to, and]
approaches: [of]
appropriate‚ù: [So]
approved: [Can, just, for]
arbitrary: [timetables]
are: [they, coming, coming", coming, not, a, all, ruled, ruled, dangerous, horrible, up, all, here, part, and, not, free, here, right, going, talking, already, bringing, creating, fantastic, terrific, going, going, all, going, going, our, going, not, truly, working, shrinking, very, we, all, united, brothers, bound, not, weary, much, both, immense, active, two, committed, nothing, clear, going, a, not, killing, housing, fighting, committed, won, already, confident, going, now, not, dealt, and, fighting, gathered, also, not, proudly, committed, never, the, a, This, you, dire, threats, threats, confronted, fighting, confronted, If, doomed, doomed, resilient, doomed, And, we, the, Those, the, shocked, coming, easy, what, clearer, no, in, many, the, here, not, shaping, our, going, you, a, doing, American, that, well, you, great, red, blue, they, we, saying, indeed, indeed, beautiful, the, so, all, warmed, and, very, already, all, my, doing, seeing, working, they, also, protecting, going, really, appointmentsÄand, peddling]
area: [of]
areas: [Obviously]
arena: [when]
arent: [treating]
arising: [in]
armed: [forces, forces, forces, For]
armies: [were]
arms: [Never, I, Retribution, is]
army: [of, at, on, bent]
around: [the, the, Victory, the, here, here]
arrested: [prosecuted]
arrival: [of]
arrived: [at]
arsenal: [and]
art: [that]
as: [I, Obamacare, a, the, we, I, well, much, this, I, you, existing, I, he, he, immigrants, good, it, well, to, one, a, one, happened, we, cities, it, they, long, we, you, President, the, an, the, true, ever, a, a, strong, ever, our, pillars, nations, allies, a, they, we, the, it, their, human, ever, Poland, the, leaders, importantly, president, our, Obamacare, a, a, work, much, you, you, your, to, Americans, Secretary, your]
aside: [all, And]
ask: [to, our, for, for]
asked: [Captain, ÄYoung, me]
asking: [others]
assault: [on, on]
assistance: [and]
at: [the, that, Concord, Concord, a, whats, whats, least, least, him, this, like, , whats, whats, whats, whats, whats, whats, whats, Nice, Paris, some, Brexit, Brexit, People, trade, home, sea, home, war, home, peace, Camp, three, nothing, the, Arlington, home, this, the, the, any, anybody, Their, this, the, our, night, the, you, getting, a, this, the, all", all", the, 6., all, the, the, the]
attack: [in, in, but, we, after]
attacking: [our]
attacks: [from, after, We, against, But]
audience: [today, understands, today, right, All]
authorities: [in]
authority: [and, for]
aviation: [The]
away: [our, with, with, The, We]
away‚ù: [recalled]
back: [illegally, in, to, to, to, across, in, in, thousands, there, to, our, for, control, control, to, into, in, down, on, there, there, Well, The, In, your, his, a, he, to, to, in, very, into, into, in, with]
bad: [bad, people, student, bad, ideas, and, But, its, group]
badge: [after, of]
badly: [depleted, No, You, wanted, lost]
ban: [on, on, private, Hes, guns]
bankrupt: [and]
bare: [shred]
barricade: [And]
bars: [Otherwise]
based: [on, in]
basically: [it, what]
basis: [is]
battle: [they, against, we, right, for]
battlefield: [for, -]
battlefields: [We, And, And]
battles: [that, that, They]
battletested: [Patriot]
be: [caught, returned, arrested, successful, successful, serious, ruled, complacent, vigilant, one, saying, here, among, here, with, in, believed, let, submitting, repealed, much, a, proud, bilateral, made, made, honest, ordered, a, eliminated, record, rejected, rejected, accepted, environmentally, a, amazing, a, Ä, environmentally, detrimental, appropriate‚ù, doing, more, impressed, great, taken, doing, a, four, change, seated, solved, possible, silent, fast, borne, right, invaded, erased, joined, broken, Poland, closed, beaten, successful, weak, broken, broken, here, here, with, here, an, selling, energy, able, shown, anything, But, back, back, back, successful, spotless, successful, successful, tremendously, bringing, used, saying, saying, a, restored, feared, a, proud, proud, proud, proud, an, American, fighting, back, swamped, wasting, Pocahontas, the, coming, trying, faithful, here, great, great, armed, General]
bear: [arms, arms]
beaten: [Americans]
beautiful: [red, thank, beautiful, words, American, First, piece, Poland, capital, place, day, phrase, words, round, outdoors]
beautifully: [In]
beauty: [and]
became: [President, great, unbelievable, an]
because: [I, Ive, of, it, they, it, every, it, you, its, whats, theyre, all, that, Pakistan, we, your, of, people, our, we, as, youre, the, New, its, I, she, we, we, that, he, theres, he, our, weve]
become: [a, totally, the, great, leaders, a]
been: [charged, a, seen, calling, taking, hitting, no, reading, all, troubled, very, written, repeated, made, a, paying, a, broken, that, paying, hearing, thinking, and, And, won, downplaying, Last, taught, telling, a, fighting, empty, waiting, so, amazing, fantastic, real, a]
before: [in, I, Thats, Its, To, May, I, September, they, this, And, But, a, you, you, people, -]
beg: [for]
began: [to]
begin: [the, plans, or, on]
beginning: [the, -, of, in, believe, But]
begins: [with]
begun: [plans, to]
behalf: [of, of]
behind: [bars, the, Article]
being: [put, thrown, put, used, spent, spent, one, split, shot, president, here, a, a]
believe: [me, me, We, me, in, this, in, it, over, this, but, they, me, in, me, that, me, in, me, me, me, me, me, in, it]
believed: [which, were]
believes: [in]
belong: [to]
belongs: [to, to]
beloved: [patriotÄand]
bench: [of]
benchmark: [for]
bent: [on]
best: [things, interest, equipment, and, model, defense, anywhere, scouting, jobs, and]
better: [future, health, decisions, and, ambassador, future, know, than, citizens, The, than, get, get, Otherwise, get, get, do, feeling]
between: [the]
beyond: [Pakistan, the, description]
big: [rivers, and, part, mess, And, price, planes, difference, situation, thing, a, league, league, and, beautiful, yacht, conglomerate, conglomerate, in, thing, crowd, for, big, beautiful, difference]
biggest: [orders]
bigotry: [and]
bilateral: [or]
billion: [deal, airplane, dollars]
billions: [and, of, of, of, of, and, of, of, of, of, and, of, and, and, of]
bills: [Theyre, They]
bind: [us]
birthday: [87]
bit: [different]
blank: [check]
bled: [to, and, and]
bless: [America, you, the, our, the, the, our, the, you, you, the]
blessing: [to, to]
bloated: [bloated, bureaucracy]
blood: [together, and, in, It, of, of]
bloody: [battle]
blue: [and]
bold: [and, acts]
bond: [forged, between]
bonds: [of, of, of, of]
book: [and]
border: [is, and, theyre, and, wall, since]
borders: [again, You, and, does, and, and, even, were, will, Do, is, remove, already]
bordersÄlots: [of]
bored: [with, right, too]
born: [I]
borne: [by]
both: [parties, predictable, of, sides, sides, sons]
bottom: [The, line]
bought: [a, his, back, back]
bound: [together]
boxing: [matches]
boy: [have]
brag: [about]
branch: [officials]
brand: [new]
brandnew: [frontiers, JusticeÄand]
brave: [sailors, defenders, defenders, Polish, members]
bravest: [to]
break: [in, their, you]
breaking: [news]
breath: [on]
bridges: [and]
brilliance: [We]
bring: [back, hope, peace, about]
bringing: [in, back, back]
broadcast: [on]
broader: [region, IndoPacific]
broken: [and, And, I, Our]
brothers: [and, and]
brutal: [attacks, occupation, campaign]
budget: [Seven]
build: [the, the, what, It, safe, safe, new, their, our, and, homes, the]
builder: [became]
building: [on, a, homes]
built: [a]
burden: [will, The]
bureaucracy: [which, that, at]
bureaucrats: [in]
burned: [every]
business: [in, climate, and, And, communications, but]
businesses: [and]
but: [then, we, believe, I, the, I, for, theyre, they, weve, its, this, theyll, they, we, I, I, were, money, we, the, it, the, we, its, left, many, failure, we, I, thugs, attack, nobody, we, India, to, there, PolishAmericans, also, more, you, to, Poland, familiar, because, with, actions, also, if, the, the, you, Im, this, I, we, lets, youre, for, dont, its]
buy: [back]
buying: [it]
by: [two, the, our, each, being, the, the, the, the, the, the, a, a, the, the, the, Obama, Obama, the, the, Obama, General, all, everyone, the, history, providence, common, a, a, leaving, continuing, the, the, this, American, side, unique, Nazi, veterans, shattering, a, another, the, yet, investing, the, the, the, the, looking, that, being, himself, the, a, the, the, Your, the, the, Wear, all, saying, the, your, a, the, the]
cabinet: [were]
call: [to, went, upon]
called: [them, the, ISIS, on, William, work, the]
calling: [us]
calls: [made]
came: [the, from, over, at, on, to, to, in, up, in, in, out, to, through]
cameras: [will, back]
campaign: [to, to]
camped: [out]
campfire: [reaching]
can: [tell, proudly, tell, that, be, tell, be, tell, tell, tell, do, understand, understand, understand, stay, cherish, get, never, look, find, ever, wait, no, survive, say, still, better, have, achieve, tell, see, think, hear, handle, do, be, do, count, count, tell, tell, tell, make]
candidate: [in, is]
candidates: [but]
cannot: [be, remain, repeat, accept, fail, thank]
cant: [be, do, even, because, do, be, forgot, even, even, get, win, even]
capacity: [We]
capital: [Just, city]
capitols: [and]
captive: [nations]
capture: [Jerusalem]
car: [industry, industry]
care: [system, at, too, they, of, of, of, of, about]
career: [fighting]
carrier: [into, anywhere]
carry: [their, the]
cartels: [which, that]
case: [you]
cases: [they]
cathedrals: [and]
caught: [and, in]
cause: [with, for]
cease: [its, to]
ceased: [its, its]
celebrate: [our, American]
center: [of, of]
cents: [theyre]
centuries: [Poland, of]
century: [and, ago, that]
certain: [areas, big, obvious, skill, federal]
cesspool: [or]
chained: [down]
challenge: [our, everything]
challenges: [-]
challenging: [and]
champion: [in]
chance: [now, to]
chances: [are]
change: [for, for, dramatically, the, and, immediately, their, it]
changed: [his]
changes: [right, They]
chaos: [and, violence, throughout]
character: [that, integrity]
characters: [Its]
charged: [with]
chase: [their]
cheating: [and]
check: [but, The]
cherish: [our, us, inspiring, your]
chief: [Scout]
child: [in]
children: [To, You, together, You, to, They, suddenly, And]
choice: [and, to]
choices: [We]
chooses: [to]
circumstances: [demand]
cities: [Were, safe, and, and, To, they, Poland, and, and]
citizen: [suffers, of]
citizens: [We, Erasing, have, at, of, along, of, who, are, did, to, and, than, When, And]
city: [by, and, viciously, just, and, ÄThe]
civil: [right]
civilization: [order, For, The, itself, What, in, And, is, are, and, will]
class: [of, of, to, of]
clause: [in]
clean: [very, coal, and]
cleaned: [the]
clear: [I, We, mission, definition, that, that]
clearer: [than]
climate: [that]
clogging: [up]
close: [to]
closed: [to]
coal: [Were]
coast: [Okay]
cocktail: [party]
code: [more, and]
cohesion: [That]
collapse: [of]
collective: [defense]
college: [education]
collision: [at]
color: [to]
combat: [deserve]
combating: [the]
come: [but, on, on, up, into, home, and, all, to, from, crashing, from, to, to, here, with, to, through, to]
comes: [to, into, from]
comfort: [and]
coming: [back, the, Now, back, in, in, into, in, back, back, over, after]
coming": [Right]
commanders: [in, and]
commerce: [as]
commission: [an]
commit: [the]
commitment: [to, is, to, Words, of, of]
commits: [its]
committed: [to, to, to, members]
common: [hopes, purpose, enemies, goals, cause, enemies, In, defense]
communications: [people]
communism: [by, But]
communist: [rule, in]
communities: [safe, not, and, to, Incredible]
community: [into, headed, and, is, of, There, of, of, of]
companies: [to, to, saying, have, and, And, What, leaving, They, that]
company: [just, and, for, for, that, was, and, and]
compete: [effectively, and]
competing: [offer, and]
complacent: [These]
complain: [about]
complete: [our]
complex: [document, hand, society]
comprehensive: [review, review]
conceivable: [angle]
concentration: [in]
concluded: [that]
conclusions: [about]
conditions: [Ive, for]
conducting: [the]
conference: [including]
confidence: [and, in, in, in]
confident: [they]
confirmed: [a]
conflict: [And]
conflicts: [that]
confront: [the, them, forces]
confronted: [by, by, by]
confronting: [of]
confronts: [the]
conglomerate: [and, based]
congratulate: [you, you, Karen]
conquers: [evil]
conquest: [Then]
consequences: [of, of]
considerations: [That]
constant: [and, stream, protection]
constitution: [So]
construct: [democracies]
construction: [of, of]
continent: [no]
continue: [to, to, its, to, to]
continuing: [to]
contracts: [So]
contribute: [much, to, more]
contributions: [and, to]
control: [of, of, This]
conviction: [that]
cookies: [Each]
cooperation: [of, The]
coordinate: [on]
cops: [sheriffs]
core: [interests, pillar]
corner: [was]
cornerstone: [of]
correct: [when, wars, You]
corrupt: [system]
cost: [American, of, Do]
could: [not, not, tell, tell, happen, be, be, never, destroy, not, not, use, never]
couldnt: [sell]
count: [on, on]
counterproductive: [it]
countless: [others, members]
countries: [have, to, picked, and, in, that, are, Theyre, in, in, share, are, that, that]
country: [for, is, our, who, and, wins, over, Were, Look, Its, And, In, with, and, into, So, Right, safe, safe, and, safe, that, and, but, We, We, has, because, Its, to, We, has, needs, that, that, was, against, But, than, These, that, and, The, And, Secretary, So, and, And, and, By, to, You, you, And, So, Weve]
countrys: [were, harboring]
countryside: [to]
couple: [of, of, of, of]
courage: [and, to, sacrifice, in, and, and, to, sap, to]
courageous: [armed]
couriers‚ù: [Nazi]
course: [youre, having, I]
court: [originally, Three, that]
cover: [of]
crack: [down]
crashing: [down, end]
crazy: [trying]
create: [at, a, the, another]
created: [by]
creating: [in]
creation: [of]
credit: [The, for, is, is, but]
creed: [and]
creep: [of]
crime: [in, and, supporting]
crimes: [of, and]
criminal: [cartels, networks, gangs, aliens]
criminals: [and, and, will, drug]
critical: [part, importance, to]
criticize: [our]
crossed: [Anybody, they]
crossing: [our, never, Those]
crowd: [Not, You, A, All, this, record, of, Fake, then]
crowds: [They, And, Id]
crucially: [important]
cruel: [and]
crushing: [alQaeda]
cry: [out, out]
culture: [and, faith, and]
currency: [manipulation]
customs: [and]
cut: [short]
cutting: [off]
cyberwarfare: [we]
dad: [troop]
dads: [and]
daily: [basis]
danger: [Ä, is]
dangerous: [times, sector]
daring: [trials]
dark: [days]
dates: [we]
day: [April, that, we, one, for, in, of, to, came, every, the, And, many, Was, What, Do, forward, of, in, as]
days: [this, of, We, are, you, of, ago, The]
daysÄbut: [already]
de: [la]
deal: [to, with]
dealers: [who, traffickers, who]
deals: [and, all, where]
dealt: [a]
dear: [and]
death: [And]
deaths: [Ill, of]
debate: [everything]
decades: [of, and]
decision: [by, as, about, It, to]
decisions: [are, When, moving, a]
decisive: [action, and]
declaration: [of]
declare: [that, today]
decrease: [-]
dedicate: [yourself]
deductibles: [have]
deeds: [they]
deem: [necessaryÄ, to]
deep: [ties, in]
deeply: [in, honored]
defeat: [us, us, in, our, them, them, the, ISIS, Under, of, of]
defend: [the, freedom, freedom, the, the, our, our, and, America, The, our, their, ourselves, them, this, the, our]
defender: [of, of]
defenders: [of, of, did]
defending: [the, with, the]
defense: [community, to, and, In, of, of, The, for, commitment, system, Thank, is, of, The, and, than]
defied: [tyranny]
define: [their]
definition: [attacking]
defray: [the]
delay: [and]
deliver: [I, change, a, you]
demand: [new, no]
demanded: [that]
demands: [I, loyalty]
democracies: [in]
democracy: [and, and]
democratic: [Europe]
demolish: [freedom]
demonstrate: [its, that]
demonstrated: [not]
denies: [that]
department: [of]
depend: [on]
depleted: [You]
deportation: [you]
description: [the, of]
deserve: [to, a, the]
desire: [and]
desk: [in]
desperate: [struggle]
despite: [all]
destabilizing: [activities]
destinies: [Americans]
destiny: [and, of]
destroy: [transnational, ISIS, you, this, The, it, your]
destroyed: [the, Every]
destroying: [our]
destruction: [They, of]
detail: [and]
details: [of]
determination: [and]
determined: [to]
detrimental: [to]
develop: [a, its, talents, and]
development: [We, to]
devoted: [to]
devotion: [to]
dictate: [to]
did: [was, it, it, very, very, nicely, not, not, not, not, not, not, not, President, it, this, Should, in, this, this, was, We, in, that‚îDonald, And]
didnt: [like, know, you, write, think, read, happen, happen, know, know, mean, have, know, work, want]
died: [in, for, during, to, for]
dies: [You]
difference: [because, We]
differences: [party]
different: [when, or, states, Who, states]
dignity: [of]
diplomatic: [economic]
diplomats: [but]
dire: [threats]
direct: [route]
directed: [the, the, the, Secretary, from]
director: [was]
disadvantage: [in, in, And]
disagree: [with, with]
disaster: [known, You, known, Under, And, strikes]
discover: [brandnew, that]
discovered: [really]
discredited: [approaches]
dishonest: [media, people]
dislike: [like]
displayed: [it]
district: [that]
distrust: [with]
divisions: [within]
do: [whatever, how, business, theyre, anything, you, it, me, so, things, here, what, Thats, it, a, gets, so, you, something, is, owe, it, a, something, anything, something, that, not, Afghans, and, indeed, more, not, they, the, it, it, it, you, anything, You, He, I, love, and, things, something, something, something, is, -, something, something, something, we, you, you, your, your, you, what, these, to, it, you]
document: [in]
documentation: [There]
does: [not, not, not, it]
doesnt: [work, work]
doing: [a, the, something, for, so, so, the, that, that, a, -, a, a, it, such, well, something, a, something, great, things, is, so, a, a, it, right]
doing": [He]
dollars: [on, because, and, over, overbudget, off, on, at, in, more, more, more, from, New]
dominant: [And]
done: [well, so, few, before, is, is, so]
donors: [and]
dont: [need, want, want, get, get, have, want, know, say, think, think, give, even, know, want, want, do, fight, win, win, win, win, forget, doing, like, -, know, have, think, like, worry]
doomed: [to, not, because]
door: [Thats]
double: [occupation]
doubt: [or]
down: [Thank, on, over, our, by, evil, They, their, evil, As, again, new, Just]
downplaying: [that]
downsize: [the]
drain: [the]
drains: [the]
dramatic: [results]
dramatically: [in]
drawing: [upon]
dreamed: [of]
dreams: [from, and, what, I, they]
drew: [this]
drive: [out]
drug: [dealers, dealers, dealers]
drugs: [from, from, to]
dry: [up]
dug: [a]
during: [that, that, Pope]
duty: [and, to, honor]
duty": [country]
each: [and, generation, other, other, and, generation, morning, success, and]
eager: [to]
earlier: [in]
earliest: [endorsement]
earned: [to, with]
earning: [a]
earth: [And, the]
easier: [We, for]
east: [Thats, and]
easy: [one, for, but, trip]
echo: [through]
echoes: [of]
economic: [and, partner, assistance, development, burden]
economies: [And, and]
economy: [is]
education: [you, you, is]
effective: [military]
effectively: [and, in]
effort: [perhaps, in, we, to, to, to]
efforts: [I]
eightyear: [assault]
elected: [I]
electing: [true]
election: [and, We, It, November, takes, What, youre, -]
elections: [for]
element: [We]
elements: [of]
eliminate: [their]
eliminated: [And, the]
elite: [have]
else: [This, This, Ä, in, with]
elsewhere: [and]
embark: [on]
embarrassment: [to]
embrace: [our]
emerge: [We]
empower: [women]
empty: [land, podium, They]
enable: [terrorists]
end: [Lets, it, and, we, military, he, of, of, by, You]
ended: [up]
endorsement: [in]
endured: [and, evils, a]
enduring: [outcome, outcome]
enemies: [overseas, Our, must, The, obliterating, who, abroad, and, of, to, and, of]
enemy: [Micromanagement, Thats, forces, never]
energy: [also, money, so, Mr, And, exporter, exporter, instead, dominant]
enforce: [immigration, the]
enforcement: [Were, they, and, We, actions, In, are]
enforcing: [our]
engagement: [to]
enlisted: [in]
enormous: [price]
enough: [Were, respect, They]
enriched: [this, the]
ensure: [a, that, they, that, that, you]
enter: [right]
entertainment: [business]
entire: [Polish]
entirely: [But]
entry: [of, of, of]
environmental: [impact]
environmentally: [friendly, friendly]
equipment: [anywhere, And, for]
era: [we]
erase: [the]
erased: [from, from, for]
especially: [thank, the, in, proud, want, This, the]
essence: [of]
essential: [to]
essentially: [Whenever]
estate: [business]
eternal: [rest]
ethnicity: [creed]
even: [think, think, think, those, though, before, picked, understand, quote, the, erased, stronger, in, have, see, see, able, went, believe, think, think]
evening: [Do, Remember, remember, one, And, Big, for]
event: [theyve]
ever: [infringe, Freedom, let, let, leave, before, forget, happen, will, forgotten, The, and, exist, failed, forgotten, Poland, be, give, quit, come, hear, in, did, give, thought, ever, let, dies, happen, forget, seen]
everlasting: [peace, pride]
every: [one, one, country, poll, day, one, word, magazine, man, member, generation, line, conceivable, single, weapon, generation, fallen, family, wounded, one, effort, communist, human, person, soul, one, building, foot, last, single, year, citizen, single, one]
everybody: [thank, is, in, Ive, else, knows, has, Thank, all, Thank]
everyday: [farmers]
everyone: [Senate, in]
everything: [is, We, We, so, you]
evident: [than]
evil: [ideology, and, and, together]
evils: [beyond]
exact: [moment]
exactly: [happened, true, what, what]
example: [but, of, for, you, you]
excellence: [and]
excited: [what]
exciting: [event, evening]
executive: [branch, Michael]
exist: [again]
existed: [to]
existing: [And]
exists: [right, only]
exit: [are]
expand: [authority, authorities, our]
expect: [to]
experience: [reminds, for]
expertise: [of]
explained: [what]
explode: [The]
explore: [and]
export: [terror, terrorism]
exporter: [Isnt, In]
expose: [them]
exposing: [the]
expression: [We]
extent: [before]
extraordinary: [sacrifice]
extremely: [well, predictable]
extremism: [We, all, of]
eyes: [wide]
face: [of, in, and, of, down, down, of, of, down, hardship]
faced: [down]
fact: [Thomas, is, every, when, thats, people, she, today, countless]
fail: [if, And, They, to, This, What]
failed: [It, and, badly]
failure: [New]
fair: [trade, and, financial]
fairly: [in]
fairness: [is]
faith: [your, and, and]
faithful: [nation, and]
fake: [news, news, news, news, media, news, polls]
fallen: [hero]
false: [story, stories, allure]
familiar: [to]
families: [and, You, with, of, will, and, your]
family: [The, its, They, who, not, for]
famous: [warning, for, night]
fan: [but]
fans: [said]
fantastic: [I, justice, job, job, Theyve]
far: [off, from, side, too, too, as]
faraway: [lands]
farmers: [frontiersmen, and]
farms: [and]
fast: [and]
fastest: [and]
father: [flew]
favor: [give]
favorite: [slogan]
fear: [then]
feared: [and]
federal: [lands, agencies, lands]
feeling: [than, that]
feels: [its]
feet: [wide]
fellowship: [that]
fence: [Come]
fences: [Amazing]
few: [days, words, feet, are, good, have]
field: [We, Because, for, Ultimately, from, drawing, we]
fight: [to, to, politically, Im, for, our, in, and, to, to, alongside, for, against, for, Just, like, for, in, against]
fighter: [jet, jets, jet]
fighters: [began, made]
fighting: [and, battles, battles, But, to, for, hard, when, He, with, crime]
fights: [Were, in]
figure: [it]
fill: [just]
filled: [with]
filter: [of]
final: [element, meeting]
finally: [got, I, meet]
financial: [and, crimes, obligation]
find: [a, the, the, a, no, out, your, out, it]
finds: [that]
fine: [person]
fire: [-, -]
fired: [Were]
fired": [Ill]
firm: [firm, stance]
firmly: [within, behind]
first: [And, generation, thing, day, visit, mass, You, time, sitting, time, 0, day, time]
five: [year, Polish]
fiveterm: [President]
fix: [it, our]
flag: [and, We, and, and]
flags: [next]
fleet: [of]
flew: [them]
flow: [across]
fly: [in]
flying: [them]
folks: [Nothing, in, Im, we, Theres, in, But, cannot, Im, Its]
follow: [has, you, Generations]
followed: [through, Our]
following: [the, my, ways, through]
foot: [of]
for: [independence, those, that, certain, our, the, the, a, two, what, the, your, yourselves, your, the, those, companies, companies, the, terminating, the, honest, fighter, the, what, saving, every, the, companies, the, me, us, reducing, protection, the, such, those, our, the, our, once, all, our, a, the, the, the, the, all, the, Obamacare, two, us, human, themselves, the, the, all, justice, our, our, the, America, all, prejudice, bigotry, hate, peace, victory, and, ISIS, yourself, that, the, further, the, terrorist, Pakistan, America, peace, American, a, Not, a, which, our, which, leading, the, a, freedom, others, more, a, Poland, freedom, their, wealth, privilege, hostile, excellence, our, our, its, its, being, investment, our, Warsaw, the, their, the, the, family, freedom, country, God, all, making, the, our, our, being, it, it, our, your, me, nails, 0, his, a, a, Donald, make, our, an, every, you, me, me, that, your, his, freedom, the, the, the, open, Karen, everyone, a, all, the, me, you, your, everything, us, us, for, a, all, this, Americas, criminals, them, them, MS1.]
force: [for, for, Our, aims]
forced: [into]
forces: [to, As, become, stopped, into, whether, will, too, knocked]
foreign: [cheating, countries, government, policy, terrorist]
forest: [massacre]
forever: [by]
forged: [by]
forget: [our, what, that, that, who, who, The, We, America, that]
forgets: [the]
forgetting: [about]
forgetÄa: [lot]
forgot: [these, that, about]
forgotten: [who, It, people, people]
form: [of, a]
formed: [the]
former: [President, Boy, national, fiveterm]
forms: [of]
forum: [last]
forward: [in, Military, this, Remember]
fought: [alongside, with, and, for, to, for, and, side, and, long]
found: [it, new, the, them]
foundation: [of, here, from]
founded: [Time]
founding: [of]
four: [weeks, decades, times]
fragile: [link, crossing]
frankly: [across]
free: [and, and, President, nations, A, speech, expression, sovereign, And]
freedom: [in, for, Be, and, Through, but, and, The, and, Thank, your, and, That, and, together, to, fighters, our, for, Wayne, With]
freedomloving: [Americans]
freedoms: [also, restrict, and, of, that, has, as, of]
friend: [but, because, and]
friendly: [and, and]
friends: [and, at, believe, of, The]
friendship: [stand]
friendÄhes: [become]
from: [/1, other, the, the, government, God, The, the, 04,0, Lockheed, law, military, crimes, pours, my, one, their, every, battle, every, Afghanistan, Iraq, crossing, coming, history, a, now, partnering, terrorism, fully, Washington, taking, where, its, an, the, history, your, the, the, the, the, inside, the, our, our, the, countries, the, being, the, Big, the, everybody, now, companies, wrong, this, the, which, Heritage, pouring]
front: [door, I, And, of]
frontiers: [We]
frontiersmen: [shopkeepers]
frontline: [soldiers]
frustration: [I, over]
full: [and, day]
fully: [knew, and, enforcing]
fun: [that]
fundamental: [conclusions, pillar, question]
funding: [and, increases, and]
further: [You, than, military, develop, and]
future: [and, I, of, to, We, in, They, Americans, by, That, of, and]
gain: [from, momentum, that]
gains: [slipped]
gang: [members, members, members, members]
gangs: [and]
gas: [and]
gathered: [tonight, around]
gathering: [in, of]
gatherings: [like]
gave: [comfort, safe, their, more]
general: [election, a]
generals: [in, to]
generation: [of, to, to, have, we, must]
generations: [have]
generosity: [you]
geographic: [heart]
get: [that, tough, it, it, away, away, them, caught, here, All, His, on, it, what, the, them, them, somebody, Senator, the, up, bored, bored, their, out, out, any]
gets: [a, the, or]
getting: [the, in, rejected, into, zoning]
giant: [a]
gift: [from, from]
girls: [and]
give: [me, me, them, up, up, up, up, it, up, in, them, us]
given: [as, their, a, up]
gives: [safe, us]
giving: [it, you]
global: [elite, partners, threat]
globe: [Look, America, So]
glorious: [American]
glory: [in, of]
go: [back, on, away, to, to, to, any, in, on, to, to, shopping, out, Michigan, with, to, so]
goals: [that]
gods: [earth]
goes: [Äfor, Not, Dont]
going: [to, to, to, to, to, for, to, to, to, out, to, to, to, to, to, happen, to, to, to, to, to, to, to, to, to, to, to, to, extremely, to, to, to, ten, to, to, to, to, to, to, to, to, have, to, to, to, to, to, on, to, to, to, to, to, to, to, to, to, to, to, to, to, to, to, to, to, to, let, to, back, to, to, to, to, to, to, on, on, to, to, on, to, to, to, to, to, to, to, to, to, to, to, to, to, crazy, to, to, to, on, to, to, to, to, to, to, to, to, to, to, to, to, to, after, after, after, after]
gone: [so, after]
good: [high, enough, Okay, I, He, shape, When, as, of, people, conquers, place, Not, And, guy, And, We, job, years, time, job, job, was, news, And, man]
got: [smart, into, Boeing, that, the, Boeing, the, Boeing, in, numbers, to, to, nothing, to, my, more, bored, invited, back, to]
gotten: [hundreds]
govern: [ourselves, their, them, their, their]
governed: [ourselves]
government: [Freedom, that, that, lien, And, that, and, as, of, bureaucracy, and, Many, in, be]
governor: [of]
governors: [here]
grave: [sites]
great: [job, American, war, times, to, victory, again, movement, movement, schools, healthcare, spirit, company, plane, plane, Great, Secretary, He, Hop, Dont, job, border, group, for, rebuilding, job, great, people, veterans, Justice, politically, nation, great, citizens, again, detail, nation, diplomats, region, because, and, cities, heroes, spirit, not, community, honor, honors, government, state, job, great, story, people, Boy, great, Americans, You, people, guy, William, But, Our, again, again, again, American, equipment, to, Scouts, pride, country, again, people, time, guy, evening, evening, defender, Ryan, Weve, military]
greatest: [presidents, defeat, symbol, patriots, heroes, community]
greatly: [appreciated, from, enriched, enriched]
greats: [ever]
ground: [-, and]
grounds: [than]
group: [back, of, of, in, called, of, Boy, Not]
groups: [they, will, that]
grow: [recruit, your]
growth: [and]
guess: [we]
guide: [our, our, your]
gulf: [states]
gun: [fire, ownership, owners, ownership, owners, ownership, owners]
guns: [only]
guy: [doing, When, right, is, Come, is, So, And, -, Hey, He, And]
guys: [Good, Smart, that]
had: [governed, great, to, a, before, fought, a, a, a, tremendous, the, a]
hadnt: [been]
hallowed: [grounds]
hand: [but]
handily: [In]
handle: [anything]
hands: [and, of, of]
hanger: [For, as]
happen: [anymore, any, anymore, That, They, And, Also, No, America, Boy, to, to, Were, are]
happened: [before, is, Why, was, before, before]
happening: [to, to, So, in, in, Weve, in, last, in, all, with, out, and, Theyre, for, But]
happens: [Heres]
happiness: [and]
happy: [That]
harbor: [criminals]
harboring: [of]
hard: [working, to, against, work, work, at, on, its, work, and, there, there, at, to, and]
harder: [for]
hardship: [gives, when]
hardwon: [gains]
has: [answered, never, published, been, begun, to, to, the, led, an, produced, renewed, spent, much, much, been, also, promised, many, joined, been, resumed, never, never, something, demanded, demonstrated, to, actually, the, Let, no, picked, won, won, come, been, gone, spent]
hastily: [and]
hasty: [withdrawal, withdrawal]
hate: [The]
hatred: [to]
hats: [-]
have: [these, certain, been, some, other, them, their, strong, a, strong, been, just, tremendous, pine, a, to, two, it, been, signed, made, it, projects, a, freedom, to, a, a, said, heart, those, the, ordered, planes, the, been, kept, to, gone, to, spirit, our, no, done, the, to, nothing, fought, shed, raised, given, not, been, earned, inherited, the, a, worked, suffered, been, to, the, already, nowhere, achieved, every, a, made, done, to, faced, always, fought, paid, not, also, their, dreamed, welcomed, shown, just, lost, never, fought, never, never, never, known, known, to, suffered, While, to, what, always, been, begun, been, to, to, The, the, enough, the, the, strong, a, at, camped, we, a, to, confidence, plenty, to, to, to, to, some, some, that, to, the, it, to, to, a, -, to, to, been, always, sworn, done, meaning, a, 1, breaking, a, a, plenty, bled, many, won, been, been, news, a, been, confirmed, made, selected, a]
haven: [for, to]
havens: [that, for]
havent: [seen]
having: [problems, a, a]
he: [was, was, said, came, said, did, is, has, shall, or, shall, may, feels, said, said, is, is, came, better, he, he, I, was, was, did, did, was, sold, went, had, did, had, said, did, bought, bought, worked, worked, failed, failed, was, was, said, explained, said, took, got, didnt, lived, was, loves, loves, cant, Hes, He, is]
headed: [by]
heal: [and, our]
health: [care, care]
healthcare: [plan, tragedy, its, and]
healthy: [as]
hear: [your, your, those, that, Through, of, when, that]
heard: [that, around, that, that, there, about, about, about]
hearing: [about, were, that]
heart: [of, by, of, and]
hearts: [to, courage, In, are]
heaviest: [burden]
hed: [fought, build, go, scour]
heed: [America]
held: [our, hostage]
hell: [out, out, on, wants, out]
help: [us, us, us, defray, rebuild, other, to, people, to, electing, our]
helped: [to, us]
helping: [to, people]
her: [Now, In, incredible]
here: [at, Thank, today, in, to, to, because, with, today, Bring, So, Come, No, Come, Theyre, This, at, They, tonight, Who, tonight, with, to, at, today, in, today, in, in, in, to, Thrilled, The, I, tonight, will, is, tonight, tonight, Ryan, And, today, you, You, tonight, to, Where, Where, someplace, right]
heres: [what]
heritage: [But]
hero: [every]
heroes: [have, whose, And, and, Ronald, of, embrace, remind, you]
heroic: [example]
hes: [really, going, been, doing, going, for, not, running, doing, fully]
hide: [that]
high: [paying, On, school, school, you, Were]
highest: [concentration, level]
highly: [qualified]
highs: [Theyre, Its]
highways: [and]
him: [on, up, Im, Look, No, standing, Some, at, I, more, and, but]
himself: [Nobody]
hire: [American]
his: [Lexington, neighbors, nomination, life, company, company, company, company, company, money, momentum, life, unflinching, first, career, name]
historic: [action, tax, Three, gathering, political, election]
historically: [I]
histories: [and]
history: [of, of, and, American, -, was, As, or, your, Their, we, culture, take, of]
hitting: [new, an]
hold: [it, dear]
home: [Youre, with, We, One, and, Since, We, from, and, builder]
homeland: [I]
homes: [and, and]
honest: [with, probably]
honor: [the, to, God, believe, to, What, your, Ive]
honorable: [and, and]
honorary: [president]
honored: [to, by, Weve]
honoring: [our]
honors: [that, President]
hope: [and, for, since, who, of, of, you]
hopefully: [be, hes]
hopes: [and]
horrendous: [fire]
horrible: [times, thing]
horrifying: [than]
horrors: [on, together]
hostage: [to]
hostile: [regimes]
hottest: [people]
hour: [on]
hours: [of, of]
houses: [the]
housing: [the]
how: [important, to, do, counterproductive, to, to, to, to, to, all, many, are, bad, hard, youre, low, this]
however: [are]
human: [happiness, history, spirit‚ù, life, shields, trafficking]
humanity: [Yet, We]
hundred: [years, people]
hundreds: [of, of, of, of, of]
hunters: [and]
hurt: [on, And]
hurting: [our, us]
hurts: [we]
ideas: [We]
identity: [Ä, as]
ideological: [support]
ideology: [Terrorists, Ä]
if: [you, you, they, were, my, you, he, we, or, we, we, we, we, you, the, you, you, you, you, elected]
illegal: [immigration, immigration]
illegally: [after]
image: [instead, Those]
imagine: [the]
immediately: [No, recognized, went]
immense: [Today]
immigrants: [or]
immigration: [and, security, laws, laws, on]
immortality: [By]
impact: [statements]
importance: [of]
important: [is, Its, and, contributions, message, to, to, And, -, decisions]
importantly: [we, as, lives, in, they, God]
impose: [on]
imposed: [a]
impossible: [to, Things]
impoverished: [your]
impressed: [Lets]
impressive: [Youve]
in: [certain, youll, the, the, that, going, Washington, any, their, what, Florida, making, our, a, many, a, the, the, a, We, television, prison, a, the, America, our, fact, America, Theyre, like, a, and, our, quicksand, and, front, the, the, two, this, on, a, who, I, from, I, other, there, the, two, to, this, Thats, the, good, the, the, America, Chicago, Chicago, Washington, high, the, their, Germany, Sweden, large, Brussels, Syria, the, the, Washington, case, the, the, this, any, the, the, NATO, our, the, our, Afghanistan, human, their, absolutely, the, our, Afghanistan, American, our, Afghanistan, the, other, great, Afghanistan, combat, our, 01, Afghanistan, Iraq, Afghanistan, Afghanistan, any, the, Afghanistan, time, the, Barcelona, my, Saudi, this, the, Afghanistan, the, advance, Afghanistan, the, Afghanistan, Afghanistan, trade, the, South, the, the, real, the, the, Iraq, that, line, economic, faraway, our, that, protecting, eternal, those, any, Afghanistan, the, the, defense, our, our, each, the, this, welcoming, a, the, the, which, our, many, Afghanistan, our, Warsaw, the, 99, five, Europe, Warsaw, the, Warsaw, a, solidarity, that, the, many, the, Saudi, new, Ukraine, our, defense, Poland, freedom, common, Poland, Warsaw, America, our, from, my, its, the, our, our, the, the, the, their, the, the, its, our, that, Washington, front, the, the, putting, the, this, this, Montana, the, 94, West, America, the, your, yourself, your, order, order, different, the, New, the, the, New, but, the, the, the, our, the, Many, So, And, many, all, 6, the, your, your, the, the, the, doing, to, life, the, Georgia, the, Other, this, Atlanta, the, the, the, the, the, the, the, 93, the, our, the, the, the, 81, the, the, office, law, a, all, illegal]
inaudible: [of]
inauguration: [And, I, we]
inch: [of]
includes: [elements, vast, Super]
including: [Governor, our, ISIS, the, propaganda, Syria]
increase: [your]
increases: [in]
incredible: [proSecond, progress, men, and, resume, movement, crowd, group, gathering, to, By, massive, night, We, stat, What, fight, battlefields, men]
incredibly: [successful, great]
indeed: [the, want, making, making, sweeping, to]
independence: [Many, This, as]
independent: [people, nations]
individual: [freedom]
individuals: [from]
industry: [Why, is, -]
inflicted: [upon, upon]
infrastructure: [plan, To]
infringe: [on]
inherit: [a]
inherited: [one, a, from, from]
injured: [and]
injustice: [we]
inner: [cities, cities, cities]
innocent: [men, people, Today, citizens]
innovation: [And, We]
inside: [or]
insistence: [billions]
inspiration: [our]
inspire: [others]
inspired: [those]
inspiring: [works]
instantly: [fill]
instead: [of, of, join, were, of]
instinct: [was]
instincts: [But]
instruments: [of]
integration: [of]
integrity: [who]
intend: [to]
interest: [You, of, of]
interesting: [for, life, life]
interests: [above, in, are, We, In, To, That]
interviewed: [this, I]
interviewing: [people]
into: [that, rooms, office, the, your, your, your, the, the, our, our, our, the, conflict, big, the, World, NATO, do, this, our, the, your, action, our]
intricate: [problems]
introduction: [and]
invaded: [and, yet]
investing: [billions, its]
investment: [in]
invisible: [to]
invited: [to]
is: [it, getting, no, national, Governor, here, not, a, why, a, a, all, not, seen, running, you, a, fired, sweeping, killing, a, actually, actually, still, going, thanking, getting, going, so, great, born, a, a, for, so, a, what, build, badly, flying, here, a, Judge, as, also, just, our, the, unmatched, because, a, no, not, this, why, worse, a, for, the, up, to, time, to, beyond, fighting, not, not, not, being, more, truly, a, safe, known, eager, my, beautiful, the, great, great, strong, with, a, true, the, a, a, a, as, strong, a, a, as, also, invisible, strong, unmatched, true, nothing, who, the, the, why, why, also, truly, not, a, whether, today, worth, in, because, not, your, here, an, doing, also, a, going, trustworthy, a, so, going, -, some, no, a, the, he, give, a, doing, no, much, no, no, moving, she, an, incredible, hitting, going, youre, exactly, incredible, admired, proud, a, very, nobody, the, indeed, no, noÄtheres, no, now, not, he, he, really, in, in, going, essential, why, Jeff, putting, a, following]
isnt: [that, so]
issued: [a, an]
it: [Dont, Dont, Thats, He, will, We, the, the, a, By, I, I, They, in, on, The, wouldnt, is, easy, across, for, its, comes, will, Were, By, Within, I, can, is, spoken, The, Theyre, Nobody, because, was, running, Weve, really, mean, Hes, Were, Weve, was, If, I, hard, was, Maybe, And, says, says, would, should, He, goes, says, or, on, in, that, he, Ä, can, of, was, was, My, with, Obamacare, explode, And, away, belongs, exists, for, many, is, will, is, could, could, is, up, well, all, at, to, today, it, will, is, believes, is, We, is, as, was, begins, from, meant, totally, from, He, Its, They, Hopefully, As, all, Its, Do, by, If, properly, and, It, So, He, was, was, and, thats, But, a, as, out, was, to, sails, like, really, was, so, ÄThere, meant, and, And, and, Thank, the, never, And, Dont, You, against]
its: [a, also, promises, sweeping, not, going, taken, an, very, If, not, too, understandable, unaffordable, still, values, great, called, people, part, support, commitment, strategic, warriors, enemies, neighbors, borders, will, place, destabilizing, support, actions, own, future, money, decision, people, walls, relentless, defense, defenders, defense, people, about, Boy, not, not, been, been, exactly, not, hard, far, one, named, truly, my, been, been]
itself: [at, Finally, from]
itself‚ù: [he]
jet: [We, Because]
jets: [One]
job: [Governor, Youre, killing, and, for, than, President, of, He, And, for, Doing, But, right, alreadyÄ9]
jobs: [for, and, investing, I, And, It, like, but, Instead, report]
join: [hands, together, the]
joined: [by, us, on, on]
joy: [You]
judge: [and]
judges: [And, talk, Hes, from]
judgment: [and]
just: [dont, so, announced, terminated, so, issued, approved, approved, now, now, saw, Im, read, want, sweeping, as, come, to, one, as, cant, a, as, a, perilous, as, a, by, like, a, started, the, want]
justice: [to, on, together, who, in, That]
justify: [violence]
keep: [coming, and, and, radical, people, our, our, our, them, our, the, millions, doing, saying]
keeps: [its]
kept: [to, the, open, our, hearing, America, my]
key: [security]
kill: [for, our]
killers: [need]
killing: [disaster, our, terrorists, this]
kind: [We, introduction]
kindness: [for]
kiss: [Im]
knew: [what, that, something]
knocked: [them]
know: [that, you, that, that, what, coming, they, The, about, the, our, our, the, my, anything, he, in, our, they, who, the, that, that, everything, ourselves, this, our, how, that, this, this, I, after, what, Nice, life, life, anything, anything, truthfully, whether, about, having, what, we, I, my, in, that, you, we, the, I, who, the, that, theyre, I, we, that, that, about, well, what, theyre]
know": [I]
known: [as, as, around, that, it, anything, as, so, so]
knows: [that, if, this]
la: [Vega]
lack: [of]
land: [It, but, of, on, and]
lands: [or, better, Have]
large: [numbers]
largest: [democracy, in, economies, and]
last: [long, two, long, administration, election, week, night, breath, Friday, weeks, days, inch, time, year, time, full]
lasting: [peace, defeat]
late: [great, Hundreds, great, its, But, Charlton]
later: [in]
launch: [attacks]
law: [enforcement, enforcement, enforcement, enforcement, They, enforcement, and, says, You, We, enforcement, enforcement, order]
lawabiding: [gun, gun, Americans]
lawless: [secret]
laws: [and, as, your, in]
lawyers: [put, come]
lay: [out, in]
lead: [the, your, ammunition]
leaders: [We, knows, made, participating, of, of, who, When, will, and]
leadership: [of, in]
leading: [the, nation]
league: [Ä, on]
learn: [from, the, about, here, the, the, it, and, right, to]
learned: [here, in, to]
least: [000, Japan]
leave: [We, They, And, our, these]
leaving: [And, our, too]
led: [down]
left: [by, a, working, unchecked]
legacy: [It]
legislative: [houses]
length: [of]
less: [than, we, vital, defense]
let: [me, you, them, the, back, that, that, it, us, up, me, them, them, us, us]
lethal: [weapons]
lets: [tell, not, go]
level: [playing, playing, playing, of]
liaison: [girls]
liberate: [and]
liberation: [of]
liberties: [and]
liberty: [of, of]
lien: [and]
lies: [When, to, misrepresentations]
life: [Ive, or, but, You, protect, was, Our, So, -, When, in, I, You, So, and, of, I, the, and, and, compete, easier]
lifechanging: [experience]
lifetime: [ban]
lift: [restrictions]
lifted: [restrictions]
lifting: [the]
like: [and, a, dislike, Where, has, you, youve, us, , theyre, they, you, weve, never, following, PuÇaski, our, our, the, about, doing, these, it, a, to, that, I, or, thats, you, a, to, Lee, today, Trump, I]
liked: [didnt]
line: [We, And, Weve, of, with]
link: [that]
list: [of, of]
listen: [to, to, to]
listened: [to]
listening: [at]
little: [clause, while, old, bit, beautiful]
live: [or, safely, according, or, better, You, in, by, scoutings]
lived: [his, according]
lives: [and, of, Our, -, were, trying, The, This, and, We, Poland, And, you, And, the, you, never, of, will, and]
lobbying: [ban, for]
long: [period, period, time, as, as, time, years, time, and, and, time, shot, time, Washington, time]
longer: [open, And, to, You, help, are, must, be, use, confronts, will, will]
longest: [war]
look: [at, at, at, at, at, at, at, race, at, at, no, back, you, at]
looking: [good, out, at]
looks: [like]
lose: [by, our, this]
losers: [Working]
losing: [a]
loss: [of]
lost: [their, after, a, your, your, hope, that, all, my, my, his]
lot: [again, of, less, of, of, of, of, of, of, of, with, of, of, with, of, of, of, people, of, Only]
love: [This, their, Trump, us, our, for, and, in, our, this, in, And, for, for, West, to, you, you, what, When, as, it, youll, like, my, remember, work, our, our, our, our, and, And, the, him, the, the, by]
loved: [right, ones, America, one]
loves: [Poland, the, the, the]
low: [cost, this]
lower: [coast, taxes, tax, taxes]
loyal: [-, to]
loyalty: [rooted, to, that, among, I]
luxury: [of]
maam: [Perhaps, It]
machine: [gun]
made: [anywhere, in, to, without, more, especially, in, clear, their, this, 0, clear]
magazine: [all]
magnificent: [beautiful, and]
main: [roads]
major: [promise, sites]
make: [sense, a, them, them, our, it, the, plenty, our, America, the, sure, the, our, people, America, America, America, America, a, this, common, us, America, America, sure, my, are]
makes: [the, the, the, billions, sure, you, you]
making: [America, the, right, different, scouting, America, America, life]
man: [asked, on, Come, woman, named, became, who, was, a, who, of]
manipulation: [which]
many: [cases, of, others, many, millions, people, others, other, of, of, of, of, of, allies, meetings, months, times, billions, have, great, generations, wars, ways, great, Boy, years, years, many, years, Scouts, great, veterans]
man‚ù: [the]
map: [it, was]
maps: [and]
market: [Look, means, has, on]
martyr: [Bishop]
mass: [murder, terror, with]
massacre: [the]
massive: [physical, this, hanger, room, numbers, crowds, crowd, crowds]
mastering: [a]
matches: [That]
materials: [from]
matter: [In, what, But, what, how]
matters: [And]
maximize: [sanctions]
may: [be, Äby, deem, God, God, have, be]
maybe: [in, a]
may‚ù: [so]
me: [make, theyre, Im, I, a, a, so, right, Im, a, And, also, Tonight, to, Id, just, boy, Each, When, Of, You, Merry, we, But, Ive, And, that, Perhaps, and, long, the]
mean: [that, Forget, It, sincerely, anything, hundreds, those]
meaning: [he, and]
means: [defending, lifting, companies, but]
meant: [in, to, no, companies, so, a]
med: [for]
media: [which, and, lies, group, will, will, as, will, Fake]
meet: [new, their]
meeting: [last, with]
meetings: [over]
member: [of, of]
members: [and, bad, of, of, are, and, of, of, of, of, of, of, MS1‚îyou, of, who]
memories: [of, of]
memory: [And, never]
men: [and, and, and, and, and, and, women, with, women, women, and]
menace: [which]
merchants: [that]
merely: [with]
merit: [badge]
mess: [That, that, like]
message: [They, America, is]
messenger: [folks, They]
messengers: [liaison]
met: [my]
middle: [class, of, of]
might: [as, and, to, even]
militants: [and]
militaries: [have]
military: [and, Basically, We, is, Where, and, at, operate, and, options, activities, -, effort, as, might, political, And, And, wanted, Billions, general]
million: [Poles, Polish, Polish, Poles, hours]
millions: [of, of, of, of, and, of]
minds: [our]
miners: [back, go]
minister: [of]
minute: [The]
mired: [in]
misrepresentations: [and]
missile: [defense, defense]
mission: [and, to]
mistake: [our]
mistakenly: [withdrew]
model: [for]
modern: [equipment, history, political]
mom: [and]
moment: [during, And]
momentum: [And, And, I, meaning, In, And]
momentum": [You, Ill, A, But]
moms: [and]
money: [but, and, Were, working, and, to, to, it, for, at, And, He, back, is, that]
month: [since]
months: [even, we, ago, after, to, I]
monument: [to, stands, reminds]
more: [product, than, simple, fair, money, evident, with, money, is, courage, importantly, than, than, than, than, have, are, Europe, so, loyalty, and, successful, than, than, than, than, than, proud, than]
morning: [Say, The, and, the]
mortality: [and]
mortally: [dangerous]
most: [powerful, powerful, important, importantly, part, part, modern, importantly, committed, lethal, direct, advanced, important]
mostly: [young]
mountain: [summit]
mourning: [the]
move: [past, forward, troops, -, And]
moved: [very]
movement: [a, like, And, This, that, that]
movie: [because]
moving: [to, forward, to]
much: [Thank, better, lower, And, publicity, about, Our, Thats, Thank, Thank, time, different, to, to, more, Thank, Thats, Thank, I, rather, to, Ryan, for, older, as, easier, Thank, everybody, Thank, Thank, I, Great, Lee, Its]
murder: [of]
murdered: [millions]
murdering: [men]
must: [serve, be, be, we, also, seek, address, stop, prevent, never, ensure, contribute, carry, secure, unite, restore, achieve, have, have, stand, adapt, work, do, demonstrate, tell, rise, find, be]
mutual: [trust, defense]
my: [administration, inauguration, friends, birthday, promise, opponent, guy, wife, list, inauguration, national, instincts, life, Cabinet, speech, administration, inauguration, administration, first, administration, opinion, top, cabinet, life, start, momentum, momentum", business, opponent, friendÄhes, friends, friends, honor, sonÄI, selection, promise, pledge, election]
nails: [and, and]
name: [is, of, that, of, will, is]
named: [Greta, William, for]
names: [like]
narrow: [passage, passageway]
nation: [Youre, state, remains, Now, and, under, and, too, demands, must, in, and, that, With, to, that, is, of, Polish, more, forever, we, devoted, of, I, and, honors, was]
national: [security, borders, security, characters, president, parks]
nationbuilding: [again]
nations: [capital, of, in, of, to, in, of, of, The, We, as, has, is]
nationwide: [healthcare]
natural: [gas, disaster]
navigate: [for]
nd: [99]
nearly: [6, one]
necessary: [suspend, tools]
necessaryÄ: [Ä]
need: [the, the, and, a, to, when, members, and, look, to, the, that, the, a, a]
needs: [to]
negotiated: [I]
negotiation: [So]
neighborhoods: [where, To]
neighbors: [at, are]
nerveshattering: [Shes]
network: [will]
networks: [that, to, and]
never: [end, forget, ever, ever, been, ever, going, ever, thank, seen, been, give, thought, use, had, end, seem, before, know, let, again, be, lost, given, ever, lost, been, ever, lost, forget, forget, forget, known, existed, ever, back, has, ceased, ceased, ever, ever, ever, ever, thought, hear, made, forgot, quit, give, fail, ever, ever, ever, cease, ever, ever, forgetÄa, happened, happened]
new: [jobs, highs, day, business, plant, beautiful, Air, order, regulation, director, reforms, roads, solutions, loyalty, strategy, strategy, strategy, strategy, strategy, courage, citizens, forms, ways, battlefields, challenges, ships, justice]
newest: [largest]
news: [The, tell, but, and, Thank, Theyre, Donald, And, that]
newspaper‚ù: [ÄTruth]
next: [couple, week, Stretching, They, pillar, morning, to, election]
nice: [I, The, Weve, An, to, person]
nicely: [with, with, with]
night: [in, the, hed, on, with]
no: [longer, sources, way, calls, jobs, Come, credit, way, documentation, nothing, wonder, choice, longer, room, place, tolerance, further, glory, longer, place, longer, better, one, longer, less, less, better, better, matter, But, path, way, way, path, route, route, sir, thank, maam, matter]
noble: [sacrifice, American]
nobody: [believed, can, knows, ever, nobody, like, that]
nominate: [a]
nominated: [a]
nomination: [for]
nonimmigrants: [or]
north: [and]
not: [staying, going, above, a, going, going, on, your, defeat, defeat, going, gang, be, going, leaving, the, anymore, good, going, worried, worried, against, politically, in, going, for, going, make, paying, paying, at, at, been, have, talk, arbitrary, say, dictate, nationbuilding, win, asking, bring, unlimited, a, unlimited, only, only, just, be, ask, ask, because, only, government, the, win, survive, face, and, We, have, merely, just, only, have, survive, waver, begin, be, only, a, good, only, going, well, you, working, work, really, doing, forgetting, have, even, going, big, only, somebody, pleasant, pleasant]
nothing: [but, So, but, to, to, but, after, like, like]
noticed: [-, it]
now: [like, been, for, as, Secretary, theyre, we, approved, you, Its, because, Ä, Secretary, the, we, that, working, working, -, on, on, over, do, when, much, Wisconsin, the, with, have]
nowhere: [to]
noÄtheres: [no]
nuclear: [weapons, arsenal]
nucleararmed: [states]
number: [one, gets, against]
numbers: [that, Theyre, Tens, of]
oath: [to, of, fight, I, helping, you, and, guide]
objectives: [for]
obligation: [As]
obliterating: [ISIS]
obstruction: [and]
obvious: [reasons, So]
occasion: [for]
occupation: [the, In]
occupations: [the]
occupied: [by, and]
of: [individuals, dollars, those, them, our, Florida, Mississippi, Georgia, these, the, the, the, a, Godfearing, philosophy, what, a, you, Americans, all, a, the, all, the, the, the, our, time, the, here, your, weeks, the, time, the, our, new, optimism, days, jobs, dollars, the, these, taking, office, the, America, people, billions, dollars, it, billions, dollars, millions, dollars, a, money, the, aviation, Japan, dollars, time, our, the, those, law, many, protesters, words, this, Justice, violence, a, shootings, deaths, Homeland, Justice, a, our, weeks, sheriffs, people, the, any, aliens, the, these, these, groups, all, aliens, our, days, them, people, taking, thousands, people, our, defense, the, for, our, 0, our, the, course, American, delay, both, this, every, their, their, their, liberty, freedom, gods, you, peace, yesterdays, the, the, these, the, our, you, bold, America, State, the, Fort, the, our, our, our, heroes, those, our, purpose, race, the, our, America, its, love, the, our, September, blood, war, pursuing, Defense, all, the, the, lives, a, terrorist, chaos, going, the, all, the, today, a, innocent, their, their, safe, terrorists, our, our, troops, our, all, American, the, Afghanistan, their, our, dollars, militants, the, the, dollars, economic, the, engagement, Defense, wartime, American, Mosul, Afghanistan, Afghanistan, this, life, Afghanistan, the, dollars, thousands, Americas, the, those, loyalty, the, them, every, our, our, peace, you, America, a, them, all, freedom, Americas, this, trade, energy, energy, Croatia, this, land, Europe, Europe, your, your, Copernicus, that, great, what, the, hardship, hope, our, Independence, all, the, this, men, George, the, Poland, a, Vistula, this, nearly, Polands, 94, Poland, the, the, arms, the, communist, Europe, your, a, Poland, America, Europe, who, free, the, a, Europe, American, communism, life, more, humanity, their, ideological, any, aggression, responsible, civilization, the, government, the, paperwork, Europe, culture, the, that, Europe, nations, nations, art, law, our, our, our, every, every, every, people, nations, them, freedom, our, pride, free, NATO, this, dollars, dollars, the, money, will, the, its, our, those, these, the, 94, the, that, the, citizens, the, messengers, civilization, its, death, the, those, those, patriots, ground, civilization, land, Poland, history, America, people, the, that, you, what, the, being, the, mostly, the, America, character, our, our, volunteers, you, America, our, my, my, State, the, you, Indiana, love, love, love, love, the, Energy, Texas, buying, Americans, Health, saying, So, these, the, hard, building, people, Boy, you, them, Levittown, people, wood, money, money, money, wood, yachts, the, France, empty, his, Steve, the, successful, whom, Levittown, the, these, time, course, the, it, the, people, dollars, service, you, service, this, our, America, additional, dollars, the, American, our, flags, our, American, you, honor, the, America, your, yourself, the, the, you, America, our, crime, the, people, you, a, a, Michigan", Wisconsin, the, people, times, us, the, those, the, you, the, our, applause, the, selfdefense, our, a, the, 0, the, the, those, lead, the, law, law, law, the, selfdefense, here, lawabiding, the, the, action]
off: [the, the, their, long]
offenses: [in]
offer: [And]
offered: [a]
office: [Theyre, Ive, I, the]
officials: [must, and, It]
often: [times, forget, gives]
oil: [on]
okay: [Let, So, Now, Its, And]
old: [veteran, regulations, We, ally, Your, man]
older: [And]
on: [security, the, that, them, us, Earth, Earth, November, their, television, oil, shell, natural, clean, my, foreign, the, the, the, TV, television, up, up, He, This, up, Look, a, television, aliens, television, many, what, any, the, lobbying, with, businesses, the, the, the, the, our, conditions, the, Americas, our, victory, January, our, our, the, stage, your, freedom, European, earth, stage, June, the, all, both, acquiring, means, the, Earth, the, that, the, which, these, And, former, and, So, keep, all, television, the, starting, television, and, television, is, a, your, me, you, your, behalf, her, June, primaries, gatherings, the, those, your, the, certain, our, my, the]
once: [and, again, totally, great, thought]
one: [Were, I, I, of, of, of, false, big, and, media, network, Not, They, new, of, job, generation, home, glorious, nation, team, shared, shared, part, citizen, another, Thanks, denies, way, based, and, of, of, thousand, century, in, could, million, million, that, terror, firmly, of, of, country, of, young, of, of, vote, was, that, candidate, of, step, a]
oneonone: [None]
ones: [and]
only: [worried, thing, greatly, brave, among, restored, because, to, on, shaping, a, thing, for, the]
onward: [to]
open: [to, a, our, In, by, bordersÄlots]
operate: [as]
opinion: [would]
opponent: [got, didnt]
opportunities: [to]
opportunity: [to]
oppress: [you]
oppression: [From, against]
oppressive: [system, ideology]
oppressors: [tried, and]
optimism: [is, in]
options: [in, We]
or: [in, what, as, any, she, she, any, nonimmigrants, impose, whether, better, another, the, anywhere, end, our, believe, when, how, try, stop, from, destroy, out, the, perhaps, earning, zero, not, when, to, how]
order: [for, which, a, and, to, to, and]
ordered: [in, the, the, the]
orders: [in]
organization: [and, And]
organizations: [are, the, that]
original: [instinct]
originally: [by]
other: [countries, one, people, country, words, places, side, lawyers, places, people, The, As, considerations, words, groups, financial, countries, spot, side, captive, words, senators, places, millions, people, words]
others: [My, I, Being, to, who, during, to]
ought: [to]
our: [border, front, favorite, communities, freedoms, state, citizens, freedoms, liberties, children, Constitution, incredible, plans, country, country, probably, greatest, own, plan, borders, politicians, border, workers, country, country, relationship, companies, workers, allies, country, country, people, people, cops, police, police, police, law, inner, inner, youth, country, country, country, country, country, country, country, country, country, country, best, veterans, veterans, veterans, great, country, veterans, great, veterans, constitution, tax, jobs, great, country, sacred, country, borders, workers, military, infrastructure, schools, neighborhoods, inner, tax, American, legacy, nation, country, thoughts, brave, path, new, republic, country, nation, freedom, republic, country, military, nation, community, nation, hearts, wars, bravest, enemies, divisions, name, many, shores, own, security, final, strategy, nation, nation, history, hardwon, leaders, partners, allies, borders, comprehensive, new, plans, strategy, plans, new, new, effort, people, shared, warfighters, commanders, enemies, NATO, new, own, allies, collective, own, shared, children, decisions, commitment, support, eyes, military, nuclear, citizens, great, resolve, enemies, hearts, souls, military, country, beautiful, soldiers, partnership, nation, War, nations, civilization, security, way, values, people, borders, values, will, confidence, interests, alliance, fight, citizens, control, courage, spirit, will, societies, adversaries, alliance, countries, power, community, community, ancient, timeless, society, success, lives, Ä, ancestors, defense, freedom, values, history, future, freedoms, interests, tough, common, defense, time, values, citizens, borders, civilization, minds, wills, souls, civilization, civilization, survival, heart, civilization, allies, communities, nation, great, Indiana, country, country, national, energy, promise, secretary, path, government, country, industry, economy, Boy, outdoor, military, people, vets, soldiers, police, police, Armed, heroes, country, Second, country, country, wonderful, flag, freedom, soldiers, capitols, servicemembers, wonderful, citizens, nation, brandnew, administration, police, innocent, priorities, streets, youth, children, immigration, country]
ourselves: [and, Captain, and, And]
out: [often, of, Or, of, there, of, the, if, the, our, -, I, ÄWe, there, this, from, that, across, at, in, what, what, and, but, and, opportunities, have, and, and, and, there, there, I, of, We]
outcome: [worthy, Someday, worthy]
outdoor: [spaces]
outdoors: [You, Frankly, more]
outlined: [in]
outpost: [of]
outside: [of, Way]
over: [the, the, the, a, budget, he, the, television, here, the, by, 0page, the, the, the, potentially, the, a, many, Afghanistan, Instead, centuries, war, communism, time, the, I, and, the, and, our]
overbudget: [Other]
overcame: [You]
overseas: [-]
overthrow: [oppression]
overwhelming: [force]
owe: [2, them]
own: [affairs, agenda, choices, image, complex, We, nation, future, image, protection, fight, sweat, life]
owners: [No, care, while]
ownership: [of, entirely, to, saves]
packed: [with]
paid: [Our]
paperwork: [and]
parks: [and]
part: [of, of, get, theyre, of, of, of, Pakistan, of, we, in]
participate: [in]
participating: [in]
parties: [to]
partner: [and, Our, of]
partnering: [with]
partners: [are, to, must, to]
partnership: [can, with, with]
party: [and, And, It, of, And, I]
pass: [a, north]
passage: [across, required]
passageway: [just]
passion: [no]
past: [No, the, Pakistan, learned]
path: [forward, toward, to, from, to]
patience: [is]
patriot: [on, For]
patriotic: [American]
patriotism: [there]
patriots: [who, from, lay, fought, that, Mostly, especially]
patriotÄand: [you]
paved: [with]
pay: [a, a, for]
paying: [jobs, their, their, Pakistan, so]
peace: [through, weve, real, in, with, We, Another, and, to, America, We, achieves]
peddling: [their]
peel: [back]
people: [that, to, trying, to, to, This, I, and, I, The, put, just, not, dont, and, Scott, they, Theyre, in, but, right, Great, watching, out, into, There, into, We, to, that, that, that, with, We, Ive, to, We, safer, arent, When, are, will, of, how, have, We, will, of, expect, The, for, we, who, and, who, who, endured, A, did, recalled, of, of, of, our, The, were, Ä, not, have, are, for, to, The, are, will, God, here, It, You, of, -, Its, that, back, Turn, that, are, and, in, He, at, some, So, you, where, By, anymore, that, at, in, face, that, Uniformed, God, Youre, in, Theyve, didnt, will, Not, say, are, that, have, They, who, cant, You]
peoples: [frustration]
peopleÄwhere: [are]
percent: [or, decrease, You]
perfect: [cohesion, description]
perhaps: [-, it, to]
perilous: [just, sprints]
period: [of, of, of, as, there, of]
perished: [in]
perseverance: [never]
person: [and, He, a]
personally: [bankrupt]
philosophy: [No"]
phone: [call]
phony: [polls, polls]
phrase: [Youre]
physical: [structures]
picked: [by, They, by, up]
picking: [up]
piece: [of]
pieces: [of]
pillar: [of, of, of]
pillars: [of]
pine: [line]
pipe: [Who, Something, They, has]
place: [Governor, of, yesterday, for, is, in, as, In, A, on]
placed: [on]
places: [Safety, so, You]
placing: [thousands]
plain: [and]
plan: [thats, and, will, to, to, to, for]
plane: [and, represented, A, So, that]
planes: [And, Why, well, but, in, new]
planned: [and]
plans: [for, to, for, for, or]
plant: [that]
play: [their]
playing: [field, field, field]
pleasant: [for, for, for]
please: [That]
pleased: [that]
pledge: [to, to, on, to]
pledging: [to]
plenty: [of, of, of]
podium: [Because, would]
point: [out]
poison: [all]
poisoning: [our]
police: [from, not, our, do, against, by, We, Those, know, and, and]
policy: [that, fights]
political: [settlement, process, and, year, era]
politically: [correct, dont, correct]
politicians: [Its, and]
politics: [And, when]
poll: [when, was]
polls: [were, When, thats, But, are]
polluted: [vehicle‚ù]
population: [Ä]
pose: [a]
position: [okay]
positive: [elections]
possible: [from, You, to, Thank, and, and]
posts: [and]
potentially: [even]
pour: [back, into]
pouring: [into]
pours: [into]
power: [-, alone, in, is, prestige]
powerful: [army, army, As, declaration, who]
powers: [that]
practically: [run]
pray: [for]
prayer: [A]
prayers: [to]
predators: [and]
predictable: [and, consequences]
prejudice: [no]
preparing: [for]
present: [will]
presented: [a]
preserve: [protect, our, it, our]
presidency: [That]
president: [has, of, of, I, The, of]
presidents: [fought]
press: [will]
prestige: [and]
pretend: [they]
prevail: [You, We, and, Our]
prevailed: [We, because, Poland]
prevails: [Despite]
prevent: [nuclear]
prevented: [the]
preventing: [the]
previous: [administration, administration, administrations]
prey: [on]
price: [for, down, is, of, that]
priceless: [ties]
pride: [in, So, and, in, in]
primaries: [and, lets]
prime: [minister]
principled: [realism]
principles: [you]
priorities: [into]
prison: [but]
private: [gun]
privilege: [Instead]
proSecond: [Amendment]
proSecondAmendment: [toughoncrime]
probably: [anywhere, have, an, read]
problem: [They, solver]
problems: [like, But, will, of]
process: [to]
proclamation: [and]
produced: [a]
producing: [jobs]
product: [stamped, Sell, back, by]
profound: [honor]
progress: [in, However, and]
project: [is, I, is]
projects: [going]
promise: [to, you, you, that, to, I, We, to, of, We, you, and]
promised: [we, we, that]
promises: [A]
promote: [responsible]
propaganda: [financial]
properly: [We, And]
prosecute: [this]
prosecuted: [and]
prosperity: [Were, We]
prospers: [and]
protect: [and, our, those, us, its, our, many, our, her, the, the, our, a, our, the]
protecting: [our, American, the]
protection: [and, Ä, repair]
protects: [in]
protesters: [out]
proud: [again, again, to, nation, to, and, of, of, of, of, of, indeed, to, to, to]
proudly: [say, joined]
provide: [the]
providence: [We]
public: [officials, safety]
publicity: [as]
publicly: [presented]
published: [one]
pull: [out]
purpose: [They, mutual, and]
pursue: [peace, real, common, their, innovation]
pursuing: [our, our]
push: [onward]
pushing: [ahead]
put: [behind, America, into, in, into, the, this, a, out, faith, up, aside, that., that, into]
putting: [America, back, our]
qualified: [judges]
question: [The, of, did]
quickly: [For, I, To, to]
quicksand: [Get]
quit: [Persevere, You, never]
quote: [it]
race: [after, I, ethnicity]
radical: [Islamic, Islamic, Islamic]
ragtag: [army]
railways: [all]
raise: [your]
raised: [their, statues, their]
ran: [across, through, under, up]
rapid: [exit]
rates: [in, big]
rather: [do, be]
reach: [of]
reaching: [a]
reacting: [because]
read: [where, it, it, you, it, about]
reading: [about, the]
real: [peace, stability, prosperity, time, authority, reforms, progress, results, estate, friends]
realism: [will]
reality: [I, of]
really: [liked, doing, really, hurting, mean, wanted, hurting, founded, working, dont, is, like, top, hard, Heritage, helped, something, going, fine, good]
reason: [is, They, that, that]
reasons: [But]
reasserted: [their]
rebuild: [our, countries, other, America]
rebuilding: [of]
recalled: [the, one]
receive: [the]
recognize: [those, and]
recognized: [that]
record: [setting, today, Thats, setting]
recordbreaking: [success]
recovery: [efforts]
recruit: [and]
recruitment: [keep]
red: [and, and, it]
reduce: [tax]
reduced: [to]
reducing: [violent]
reform: [We, our]
reforms: [that, real]
refuse: [to, So, to]
regard: [We]
regimes: [Ä]
region: [are, anywhere, and, Finally, but, America]
regulation: [Millions, two]
regulations: [must, It, that, but]
reinforcement: [but]
reject: [our]
rejected: [They, but, quickly]
relations: [threaten]
relationship: [with, to]
relentless: [assault]
rely: [on]
remain: [one, a, steadfast]
remains: [the, the]
remember: [that, it, your, that, this, this, that, that, that, on, Charlton, the, that, Florida, they, that]
remind: [us]
reminder: [of]
reminds: [us, us]
remove: [the, criminal]
renewed: [the, spirit]
repair: [and]
repeal: [and]
repealed: [and]
repeat: [in]
repeated: [on]
replace: [the, it, chaos, Obamacare]
replaced: [For]
replied: [ÄThen]
report: [the, in]
represented: [so]
republic: [our, we]
required: [constant]
requires: [the, that, love]
resilient: [and]
resolve: [is, we, hard]
respect: [for]
respected: [by]
responsibility: [for, for]
responsible: [nations, gun, gun]
rest: [at]
rested: [Our]
restore: [safety, the, something]
restored: [just, and]
restrict: [our, the]
restriction: [he]
restrictions: [on, the, and]
rests: [not]
result: [our, of, of]
results: [in, Our]
resume: [Hes]
resumed: [its]
resurgence: [of]
return: [to, home]
returned: [to]
revered: [because]
reverse: [this]
review: [of, American]
reward: [brilliance]
rewards: [of]
rich: [countries]
right: [through, Keeping, from, of, The, folks, of, of, now, Simple, But, there, We, And, They, to, now, now, -, here, and, here, to, here, So, You, from, So, Not, from, of, The, of, Get, So]
rights: [of, and]
rise: [up]
river: [the]
rivers: [and]
road: [was, to, to]
roads: [and, running]
roaring: [campfire]
room: [filled, packed, made, for]
rooms: [where]
rooted: [deeply]
rose: [up]
round: [of]
route: [to, Theyd, to]
rule: [Poland, of, to, of]
ruled: [by, by, by, by]
rules: [I, Buy, and, of]
ruling: [on, because]
run: [the, the]
running: [so, beautifully, east, for, against, in]
ruthlessly: [destroyed]
sacred: [duty, bonds, values, right]
sacrifice: [together, of, and, of, and]
sacrifices: [that, of, But]
sad: [The, because, and]
sadly: [treated]
safe: [and, neighborhoods, again, again, You, You, And, zones, zones, zones, zones, again, haven, haven, havens, havens, strong]
safeguard: [the]
safely: [until]
safer: [It, lives]
safety: [So, to, Do]
said: [to, very, Äwhat, Änothing, Äbecomes, day, who, who, sir, not, no, I, do, thank, for, I, last, if, he, when, whats, it, it, the, to, you, it, it, ÄThe, who, absolutely, we, would, yes, Mr, I, Mr, Not, What, Donald, these, there, there, well, could, ÄThere, that]
sailing: [and]
sailors: [who]
sails: [that]
salute: [their, your, the, the]
same: [negotiation, family, oath, flag, law, organizations, time, enemies, is, I, momentum, values, oath, law, position]
sanctions: [and]
sandbags: [amid]
sang: [three]
sap: [our]
satisfaction: [of]
saved: [us, with]
saves: [lives]
saving: [them]
saw: [this, him, it, him]
sawdust: [and, and]
say: [I, for, oneonone, for, there, that, a, when, today, there, everything, its, Tom, the, President, And, why, I, we, you, it, no]
saying: [the, everybody, the, how, repeal, -, Merry, Merry, very, We, it]
says: [This, ÄWhenever, the, a]
sayÄI: [mean]
scale: [of]
school: [education, you]
schools: [for, and]
scour: [the]
scout: [is]
scouting: [possible, was, tradition, you, way, oath]
scoutings: [adventure]
scouts: [tonight]
scraps: [of]
sea: [as]
search: [and]
seated: [Vice]
second: [home]
secret: [police]
secretary: [of]
sector: [of]
secure: [the, our, their, and, the, that, Americas]
securing: [your]
security: [is, Weve, all, interests, team, threats, and, in, forces, and, and]
see: [all, it, him, some, them, what, what, determination, real, the, whats, it, all, the, whats, these, just, them, you, a, sitting, that, those, whats, the, it, what]
seeing: [it, dramatic, a, it]
seek: [an, freedom, to, to, to, out]
seeks: [to]
seem: [necessary, to]
seen: [the, before, in, what, it, it, that, in, before, wars, That, -, a]
selected: [as]
selection: [and]
selfdefense: [for, is]
selfless: [devotion]
selflessness: [courage]
sell: [that, it]
selling: [our, it]
senators: [to]
send: [our, to, our]
sense: [Senator, of]
serious: [hurt]
sermon: [when]
serve: [under, its, together, our, together, as, you, your, your, You]
serves: [the]
service: [members, members, and, to, by]
servicemembers: [here, have]
services: [Two]
set: [is, a, a, for]
setting: [time, is]
settlement: [that]
seven: [years, years]
several: [yards]
sewer": [But]
shall: [deem, seem]
shape: [Look]
shaping: [young, the]
share: [one, the, their, of, a, our, the]
shared: [common, mission, sense, objectives, interests, enemies]
shattering: [its]
she: [right, I, said, said, was, was, going, is]
shed: [their, their]
shell: [on]
shelter: [to]
sheltered: [the]
sheriffs: [and, the, group, also]
shes: [there, totally]
shields: [for]
shift: [from]
ship: [will]
ships: [great]
shocked: [But, to]
shootings: [hundreds]
shopkeepers: [merchants]
shopping: [believe]
shores: [But]
short: [period, in]
shortly: [And, after]
shot: [heard, at, at, again, Fifth]
should: [have, work, learn, take]
show: [this, the, this, business, me]
shown: [in, on]
shred: [of]
shrinking: [wages, 8]
sic,: [John]
side: [So, by, in, of, was, We]
sides: [of, in]
sign: [it]
signed: [contracts, an]
signing: [a]
signs: [of, carry]
silent: [about]
simple: [promise, rules, rules, So, for, promise, reason, words]
since: [my, the, the, our, my]
sincere: [-]
sincerely: [thank]
single: [member, day, supplier, prayer, day, day]
singlemost: [exciting]
sir: [it, no]
sisters: [We, Theyre]
sit: [behind]
site: [so]
sites: [with, for, would, all]
sits: [on]
sitting: [in, President]
situation: [We, in]
skill: [of, Theres]
skills: [you]
sky: [destroy]
slaughter: [innocent]
slipped: [back]
slogan: [of]
small: [outpost, I, crowd, pieces]
smaller: [example]
smart: [And]
smoothly: [So, And]
snipers: [shot]
so: [great, smoothly, you, many, much, you, at, good, great, many, we, plain, clear, the, By, far, nicely, they, old, much, badly, badly, its, high, much, In, many, nice, many, famous, Poland, I, that, quickly, important, do, much, nice, than, small, incredible, thank, important, when, Im, badly, bad, I, red, great, Your, many, many, well, people, far, good, unbelievably]
soaked: [in]
socalled: [global]
societies: [But]
society: [and, We, and]
sold: [his]
soldier: [understands]
soldiers: [watched, acting, to, are, Thank, still, burned, And, who]
solidarity: [against]
solutions: [Americans]
solved: [-]
solver: [-]
some: [incredible, others, of, of, states, but, day, more, -, crowd, here, in, of, of, of, evening, of]
somebody: [comes, He, else]
someone: [whos]
someplace: [They]
something: [over, next, great, but, you, else, you, you, that, that, that, that, that, that, was, very, gun]
sometimes: [forget]
son: [is]
sons: [they]
sonÄI: [can]
soon: [gave, come, Rick, trillions]
soul: [of, to]
souls: [and, And, Today]
sounds: [like]
sources: [even, of]
south: [across, of]
southern: [border, border]
sovereign: [people, people, and]
sovereignty: [We]
sow: [violence]
spaces: [must]
speak: [to, the, being, about, to, for, to]
speaking: [to]
special: [interest, class, thanks, bond, people, people, in, to, occasion, for]
specialÄNeil: [Gorsuch]
specter: [of]
speech: [in, and]
spend: [billions]
spent: [too, on, on, his]
spiral: [into]
spirit: [of, like, is, is, over, We, Your, and, with, sweeping]
spirit‚ù: [Through]
split: [apart]
spoke: [-, before, to]
spoken: [to]
sports: [fans]
sportsmen: [On]
spot: [on]
spotless: [and]
spread: [his, to]
sprints: [They]
squares: [of]
stability: [and, in]
stage: [by, today]
stamped: [with]
stance: [to, I]
stand: [and, in, in, here, united, firmly, by, up, with]
standing: [up, up, and, before]
stands: [to]
star: [is]
start: [highs, producing, very, using, winning, our, as]
started: [They, Its]
starting: [to, to, to, to]
stat: [All]
state: [leaders, I, where, remains, The, The, of, of]
statements: [and]
states: [pay, military, Arizona, whose, Anybody, It, And]
statues: [of]
statute: [is, they, is]
stay: [there]
staying: [any]
steadfast: [in]
steady: [creep]
step: [further]
steps: [to, from]
still: [not, too, something, serve, hear, cry, lives, mourning]
stirred: [the]
stock: [market, market, market, market]
stood: [up, strong, up, up, in]
stop: [the, their, at, the, the, During, the, the, the, the]
stopped: [the, and]
stopping: [it, it, mass]
stories: [they]
story: [after, of, of, of, was, thats]
strategic: [options, partnership]
strategically: [applied]
strategy: [I, I, in, is, from, is, is, for, work, with]
stream: [of]
street: [signs, was, they, they, -, was, and]
streets: [belong, and]
strength: [Our, deep, Our]
strikes: [when]
strip: [them]
stripping: [terrorists]
strive: [for]
strong: [at, borders, borders, again, and, and, For, alliance, whole, Poland, Europe, as, our, alliance, families, values, front, and, proud]
stronger: [the, ties, This]
strongly: [with]
structures: [you]
struggle: [the, to]
student: [in]
studied: [Afghanistan]
submitting: [in]
substantially: [Were]
subvert: [and]
succeed: [But, you]
success: [in, We, about, -, and, -, will, The, and, when]
successful: [That, There, outcome, meeting, and, -, man, And, people, and, And, tremendously, Now]
such: [period, as, a, a]
suddenly: [raised]
suffer: [together]
suffered: [greatly, constant, one]
suffers: [an]
summer: [of]
summit: [or]
summon: [the]
supplier: [of]
support: [on, his, for, our, is, in, that, for]
supported: [in]
supporting: [the]
supposed: [to, to, to]
suppress: [the, the]
sure: [our, that, that]
survival: [depend]
survive: [a, But, horrors, Do, If]
suspend: [the]
suspicious: [by]
swamp: [in, and, to]
swamped: [with]
sweat: [tears]
sweeping: [and, all, across, Its, across, frankly, across, across]
swift: [decisive]
swiftly: [waging]
sworn: [the]
symbol: [of, of, of]
symbols: [of]
symphonies: [We]
system: [Thomas, and, and, would, that, -]
systematically: [murdered]
tactics: [of]
take: [away, the, a, care, a, over, over, responsibility, back, back, the, ownership, heed, responsibility, pride, great, care]
taken: [steps, to, historic, decisive, over, care, care, action]
takes: [place]
taking: [advantage, the, massive, over, office]
talents: [you]
talk: [about, and, and, So, about, about, about, about, to]
talked: [to]
talking: [about, about, to, about, aboutÄwe]
talks: [By]
tanks: [in]
tape: [But]
target: [US, the]
task: [Since, force]
taught: [so]
tax: [and, reform, rates, rates, code, code]
taxes: [Less, and, very, to]
team: [with, to]
teammates: [through]
teams: [of]
tears: [resolve]
tedious: [work]
television: [Youve, General, He, saying, Everything, when, cameras, tonight, giving, November]
tell: [you, you, you, you, us, you, you, you, you, you, by, by, the, you, the, you, you, you, you, that, that, you, you, you, you, you, you, you, this, you, you, you, you, you, you, you]
telling: [you]
ten: [and]
tense: [relations]
terminated: [our]
terminating: [the]
terrible: [and]
terrific: [people, product]
territory: [cutting, and]
terror: [The, groups, When, attacks, attack]
terrorism: [and, and, and, and]
terrorismrelated: [offenses]
terrorist: [the, attack, enemies, group, organizations, organizations, and, threat]
terrorists: [to, A, including, of, to, and, The, In, that, who]
test: [our]
th: [, -, where]
than: [an, that, they, youre, ever, with, last, in, our, one, a, 5,0, a, 0, anybody, the, that, its, we, almost, an, that, the, a, 5, 0,0, that, the, they]
thank: [you, you, you, you, me, you, everybody, you, both, the, Boy, you, you, you, you, Wayne, you, you, each, them, really, also]
thanked: [med]
thanking: [me]
thanks: [also]
that: [final, wall, our, if, immigration, -, make, public, means, stirred, day, Paul, the, right, stood, time, great, matter, Melania, was, I, Theyve, They, polluted, was, And, you, Youve, when, wonderful, product, because, serves, keeps, we, will, one, plane, but, price, by, was, for, nobody, nice, Secret, but, phone, the, was, Right, I, decision, mess, I, way, love, can, are, Ive, go, happen, reverse, to, we, is, we, never, never, undermine, no, other, we, a, is, when, has, unite, -, nearly, has, decisions, have, country, gave, terrorists, the, could, we, terror, enable, matter, includes, will, pose, try, we, will, will, you, prevented, sow, no, regard, our, allow, country, chooses, so, your, your, so, is, former, it, I, from, Ä, followed, exists, brutal, hell, more, desperate, no, spirit, day, their, Poland, echo, powerful, impoverished, victory, defied, is, A, seeks, they, seek, drains, threaten, make, these, you, honor, we, bind, foundation, a, all, in, the, we, it, future, has, our, never, road, street, kept, street, street, street, life, small, the, each, every, unite, bare, fight, the, was, Were, aside, come, I, I, I, Ten, when, Hi, we, nice, you, are, you, That, before, youve, Im, this, is, By, cant, you, momentum, because, bought, isnt, that, man, But, never, moment, same, are, you, you, you, you, you, you, you, I, day, a, famous, incredible, map, came, cant, money, nobody, little, is, the, you, have, were, are, great, ship, their, you, you, there, kind, hes, I, does, We, wasÄNovember, a, evening, Remember, Tremendous, a, evening, You, was, candidate, in, And, I, our, Wayne, we, youve, if, worked, happened, folks, Youve, Youve, On, our, responsible, the, Our, when, prey, wall]
that.: [Were]
thats: [going, for, good, the, right, good, really, going, very, OK, called, also, okay, exactly]
that‚îDonald: [Trump]
the: [wall, wall, wall, wall, world, message, attacks, United, world, cooperation, NRA, beginning, other, beginning, Constitution, Constitution, United, Second, freedomloving, audience, right, people, heart, day, famous, British, British, shot, world, most, war, Stamp, Tea, old, Captain, right, bureaucrats, Second, task, first, call, liberty, right, most, United, NRA, Lords, future, people, filter, fake, truth, problem, corrupt, media, media, primaries, general, fake, truth, whole, truth, way, streets, country, job, most, hell, future, way, place, disaster, plan, restrictions, miners, last, inaudible, USA‚ù, product, border, last, relationship, people, donors, country, stock, every, country, last, new, job, TransPacific, world, way, oath, construction, Keystone, Dakota, pipe, pipe, pipe, bottom, United, big, way, crowd, plane, project, generals, fighter, way, project, folks, way, price, way, biggest, history, F3., last, Prime, F3, same, first, media, way, length, Environmental, most, veins, environmental, rules, companies, incredible, military, messenger, messenger, line, fence, best, morning, morning, way, way, fences, Department, creation, Department, Department, United, drugs, southern, construction, hell, laws, statute, sheriffs, appellate, way, way, statute, decision, statute, other, President, entry, United, United, interest, United, countrys, President, only, women, way, CNN, phony, entry, president, right, best, next, way, bottom, world, way, gulf, of, traditions, defense, department, great, united, military, father, son, best, world, care, bloated, government, swamp, executive, American, late, Senate, good, country, Democrats, tell, fake, Democrats, presidency, Senate, House, greatest, modern, Democrats, Republicans, Democrats, wrong, American, middle, Democrats, Senate, healthcare, Republicans, American, cover, world, globe, lives, best, American, greatest, face, chance, ages, ages, workforce, regulations, fight, countries, countries, discredited, past, next, first, time, name, differences, United, Cabinet, men, United, families, search, details, servicemembers, founding, battlefield, heroic, inspiration, same, American, same, same, same, world, courage, men, sacred, vigilance, American, world, scale, reality, extraordinary, American, war, longest, American, desk, Oval, United, tremendous, sacrifices, tools, trust, consequences, worst, hands, mistake, security, broader, highest, world, luxury, end, reality, world, threats, confronting, problems, mass, false, next, resurgence, hands, world, following, United, dates, ground, integration, Taliban, Afghan, Afghan, Taliban, field, people, Afghan, approach, Taliban, region, past, same, same, very, South, worlds, United, United, area, broader, brave, American, necessary, previous, Secretary, field, enemy, field, judgment, enemy, terrorist, reach, field, campaign, liberation, Taliban, heaviest, good, prime, cost, same, Afghan, less, terrorist, conditions, Afghan, military, oath, face, Earth, months, cause, bonds, enormous, months, sacrifice, defeat, arrival, United, Polish, United, 06, Warsaw, Polish, tremendous, world, Solidarity, entire, generosity, leaders, Three, citizens, President, geographic, Polish, soul, map, farms, cathedrals, proud, true, Polish, beginning, enemies, right, Polish, White, name, worlds, courage, will, story, Miracle, Soviet, west, Soviet, east, Polish, Katyn, occupations, Holocaust, Warsaw, Warsaw, destruction, deaths, largest, Nazis, summer, Nazi, citizens, Warsaw, other, river, Soviet, Nazis, city, Polish, human, other, very, day, exact, Polish, promise, words, people, people, Poles, West, most, NATO, nations, West, world, entry, transatlantic, United, specter, West, globe, leaders, innocent, West, powers, community, Atlantic, Poles, steady, vitality, people, nations, South, East, bonds, past, fastest, greatest, rule, right, center, dignity, rights, hope, priceless, people, powerful, foundation, cornerstone, foundation, very, best, United, mutual, United, battletested, best, world, Polish, NATO, benchmark, example, Polish, defense, West, will, West, will, confidence, desire, courage, face, largest, most, critical, story, Warsaw, main, battle, Polish, ability, center, city, Uprising, Poles, enemy, Poles, brave, fragile, Uprising, street, blood, blood, street, Poles, Poles, will, face, last, Uprising, fragile, Polish, Warsaw, decades, memories, Jerusalem, West, blood, West, battlefield, ties, hope, world, West, Poles, Polish, United, policy, fake, hell, Boy, job, United, honorary, Boy, young, sacred, thousands, moms, dads, Boy, future, future, present, swamp, word, word, word, reason, reason, American, highest, White, United, governor, scouting, way, television, Interior, way, best, great, National, globe, folks, way, Scout, votes, way, votes, other, way, patriotic, Boy, adventures, same, Scout, rewards, satisfaction, way, chances, way, way, road, word, sites, site, workers, next, sites, time, Boy, company, nails, sawdust, scraps, things, south, end, hottest, party, great, party, party, real, entertainment, corner, once, Hollywood, greats, only, momentum, word, big, time, end, year, election, forgotten, way, forgotten, maps, Republicans, Democrats, Electoral, East, way, polls, other, best, beginning, Boy, Scout, way, Trump, words, end, beauty, Boy, Boy, values, same, way, billions, way, fleet, United, newest, world, USS, scouting, brave, country, example, same, same, principles, people, lives, dreams, uniform, country, years, heritage, Boy, United, fight, way, same, NRA, Second, sky, district, perfect, renewed, beloved, late, NRA, last, middle, middle, state, state, evening, way, East, Republicans, Electoral, whole, different, vote, Second, NRA, movie, vote, singlemost, General, President, United, next, NRA, NRAs, history, organization, first, NRA, Second, freedoms, battlefields, audience, Veterans, VA, freedoms, podium, way, beginning, White, government, NRA, very, outdoors, outdoors, sacred, loss, Constitution, Constitution, way, people, bench, United, first, modern, first, credit, audience, audience, previous, use, Interior, previous, rule, incredible, NRA, right, criminals, hell, freedoms, criminal, NRA, most, police, Second, first, drug, gang, effort, borders, drugs, way, wall, borders, human, drugs, wrong, wall, southern]
their: [own, time, country, flag, lies, own, agenda, lies, decision, ruling, cities, country, tactics, countries, lives, family, bills, bills, blood, lives, children, posts, last, lives, lives, deeds, frustration, territory, funding, evil, will, recruitment, future, society, own, ability, courageous, country, own, own, way, share, lives, blood, support, homeland, very, Polish, oppressive, voices, oppressors, identity, territory, funding, networks, dreams, destinies, full, most, perilous, tanks, effort, part, road, American, money, memory, access, very, poison]
them: [all, not, properly, great, they, up, out, get, for, the, back, They, money, but, over, no, We, cant, and, Their, so, from, and, handily, to, to, will, And, We, of, to, to, it, at, come, come, come, down, in, He, Oh, Man, -, And, far, a, enough, anymore, anymore, the, out, As]
themselves: [but]
then: [we, a, a, we, And, you, he, when, Wisconsin, you, too, you]
there: [one, would, Come, was, and, was, and, is, is, is, are, They, is, so, please, was, were, is, is, is, because, You, because, Why, is, fighting, for, is]
theres: [another, nobody]
these: [massive, leaders, deals, were, phony, she, judges, countries, deep, problems, networks, shared, values, forces, forces, things, bonds, people, politicians, massive, leaders, incredibly, major, guys, dishonest, massive, things]
they: [Good, pretend, have, make, just, could, could, are, will, came, say, want, do, were, need, have, would, were, would, want, stood, wear, were, interviewed, were, wrote, were, drew, didnt, dont, never, can, need, come, were, said, want, are, achieved, return, will, need, have, had, can, confront, are, have, have, emerge, will, have, were, gave, are, found, know, are, may, come, were, were, do, should, built, ran, ran, were, used, asked, will, see, are, learned, tell, cleaned, didnt, didnt, couldnt, called, said, ever, said, said, didnt, said, allowing, once, love, were, said, keep, were, love, love, love, Are, around]
theyd: [sayÄI]
theyll: [be, do]
theyre: [not, big, bold, starting, going, being, going, never, going, going, competing, going, going, going, troubled, ruling, doing, doing, doing, big, on, not, trying, trying, trying, doing]
theyve: [been, never, ever]
thing: [he, Were, that, for, known, Ive, they, never]
things: [they, and, let, he, about, that, that, and]
think: [about, about, about, that, of, its, the, so, we, youll, of, that, of, of, the, this, of, hes, you, they, about, about]
thinking: [about]
this: [conviction, We, organization, stock, audience, very, massive, is, crowd, I, is, last, man, massive, man, guy, crowd, crowd, Ä, is, In, Sweden, nationwide, incredible, choice, room, more, life, war, strategy, struggle, war, effort, global, includes, region, city, monument, great, historic, magnificent, friendship, time, beautiful, nation, incredible, faithful, menace, better, incredible, extent, insistence, everybody, everybody, Ä, week, city, city, incredible, a, and, yard, big, horrible, is, incredible, for, is, life, party, happen, happen, period, to, youre, is, was, its, state, country, Jamboree, day, is, arena, forum, but, it, number, goes, number, Weve]
those: [beautiful, everyday, Redcoats, who, who, people, people, beautiful, companies, who, people, safe, safe, people, who, conducting, watching, who, contributions, sacrifices, hallowed, who, dark, words, voices, who, who, who, who, who, cameras, car, Democrats, incredible, who, people, people]
though: [they, many, their]
thought: [that, I, possible, possible, about, this, was, were]
thoughts: [and]
thousand: [years]
thousands: [of, and, of, of, of, of, and, of]
threat: [is, to, arising, Terrorists]
threaten: [to, America, us, over, our]
threatens: [all]
threats: [we, we, to, We, We]
three: [jobs, fundamental, months, simple]
thrilled: [with, that, to, 9th]
thrive: [And]
through: [our, on, strength, it, history, this, that, daring, for, for, on]
throughout: [the, Afghanistan, your]
thrown: [out]
thugs: [and]
ties: [in, of, that, that]
time: [to, we, to, on, That, And, The, has, Ford, its, Incredible, for, to, energy, and, they, for, with, by, to, is, he, You, especially, ago, off, Were, And, in, He, we, Youll, The, in, that, and, in, you, Heading]
timebased: [approach]
timeless: [traditions]
times: [These, for, again, on, how, because, In, I]
timetables: [-]
tiny: [group]
tired: [echoes]
to: [build, General, get, illegal, break, your, Boston, San, enter, happen, get, put, preserve, every, keep, come, be, be, the, govern, govern, be, make, abolish, the, follow, defend, defend, keep, the, be, be, tell, tell, be, be, be, speak, you, report, get, people, expose, win, let, do, live, believe, speak, families, where, be, take, complain, put, work, work, enforce, happen, make, do, leave, another, make, have, sell, pay, leave, pay, the, the, optimism, start, be, be, pour, withdraw, it, have, be, crack, end, begin, sign, be, have, signing, have, fly, planes, talk, be, do, be, them, make, be, Democrats, them, be, be, be, be, be, navigate, foreign, do, have, unfreeze, be, build, build, start, happen, do, give, say, Ä, this, the, thank, thank, take, protect, cherish, make, make, coordinate, destroy, stop, secure, keep, enforce, a, believe, the, do, Thats, be, keep, these, keep, keep, vet, keep, do, build, have, have, do, come, be, develop, totally, begin, start, make, do, be, let, be, take, downsize, drain, the, replace, support, win, take, take, be, tell, stop, get, lower, reduce, make, lower, increase, take, work, replace, the, do, do, the, fix, join, pass, build, take, take, defend, protect, serve, go, win, start, deliver, secure, our, our, replace, help, those, brag, the, the, all, every, call, the, the, those, lay, say, the, those, all, preserve, unify, heal, remain, serve, the, our, each, our, one, patriotism, fight, return, a, defeat, heal, the, fight, the, talk, rebuild, undertake, pull, complete, fight, win, terrorists, liberate, spread, grow, agents, spiral, understand, commit, stripping, threaten, prosecute, one, announce, begin, attack, have, the, take, govern, achieve, the, live, govern, change, deal, the, gain, lose, harbor, kill, change, demonstrate, civilization, peace, further, stability, help, pursuing, make, defeat, target, know, hide, defeat, eliminate, export, battle, apply, win, win, support, our, be, participate, help, us, defend, do, succeed, construct, rebuild, protect, change, pursue, live, Afghanistan, create, achieve, see, stand, protect, defend, come, victory, your, deliver, have, stand, the, address, Prime, your, your, expand, securing, alternate, a, Central, the, transform, one, visit, hold, summon, defend, almost, defend, be, always, overthrow, destroy, survive, demolish, break, face, declare, God, understand, do, live, the, the, the, say, our, our, export, get, stop, join, drive, strip, terrorism, justify, test, compete, cease, instead, some, the, chase, confront, undermine, erase, defend, fail, fail, fail, say, explore, free, know, live, this, preserve, lose, a, build, pour, know, secure, move, remember, prevail, have, survive, defend, protect, preserve, one, Poland, Warsaw, both, move, form, pass, keep, protect, flow, defend, her, capture, the, build, hear, be, address, put, put, talk, think, achieve, speak, speak, you, thank, be, salute, Washington, change, the, the, be, him, the, me, thank, keep, gets, start, get, vote, vote, now, watch, American, understand, say, happen, people, be, believe, have, take, be, succeed, do, find, do, a, be, success, find, get, work, find, your, You, these, tell, them, buy, develop, the, him, talk, him, him, you, you", be, people, know, have, go, learn, do, know, do, be, happen, work, be, tell, victory, figure, say, practically, victory, 7., Maine, win, Mexico, move, move, Michigan, Ohio, peel, Wisconsin, Wisconsin, lose, tell, you, be, be, help, contribute, your, take, seek, serve, help, do, do, God, be, be, helping, the, us, Norfolk, commission, veterans, ensure, follow, the, be, congratulate, me, achieve, give, doubt, fear, make, end, also, congratulate, raise, the, vote, be, be, be, be, run, forget, 7.Ä, suppress, the, suppress, 7.Ä, speak, you, be, be, say, come, receive, be, address, thank, defend, safeguard, give, see, do, ban, deliver, make, a, undermine, promote, protect, the, ensure, this, the, thank, thank, be, stand, restrict, hear, be, be, restore, public, secure, be, protect, this, use, use, stop, stop, stop, this]
today: [As, To, to, and, also, that, in, not, by, before, as, were, with, Control, as, for, You, I, Dr, because, your, I, and, not]
today": [Thats]
together: [Thank, to, Our, and, fought, and, by, -, -, by, Loyalty, as, against, today, to, to, as, did, did, only, let, Remember]
told: [Boeing, you, Ill, me, them, she]
told.: [She]
tolerance: [for]
tomorrow: [to]
tonight: [Right, to, to, that, hundreds, Thank, might, I, Come, One, will]
too: [high, much, obvious, often, much, soon, are, I, believe, late, late, nerveshattering, So, long]
took: [an, our, place, in, on, this]
tools: [they, and]
top: [advisers, job]
total: [kill, immortality]
totally: [safe, destroy, unaffordable, rested, changed, impossible, for, for]
tough: [Its, Under, stance, fight]
toughoncrime: [Attorney]
toward: [a, killing]
trade: [deals, deals, prosperity, We, with, and]
tradition: [that, So, And]
traditions: [of, and, and, they]
traffickers: [and]
trafficking: [to]
tragedy: [Its, You]
tragic: [collision]
transatlantic: [bond]
transcend: [every]
transform: [you]
transnational: [criminal]
traveled: [to]
treasure: [the, the]
treated: [These]
treating: [us]
tremendous: [trade, sacrifices, warmth, group, spirit, amount, amount, disadvantage, crowds, work, disadvantage]
tremendously: [successful, successful]
trench: [Finally]
trials: [you]
tribute: [to]
tried: [to, to]
trillion: [Okay, infrastructure]
trillions: [of]
trip: [youre]
triumph: [of, So]
troop: [and, leaders, leaders]
troops: [or, will, and]
trouble: [Thats]
troubled: [like, now]
troubling: [situation]
true: [true, defender, admiration, value, in, today, Our, He, friends, friend]
truly: [love, great, amazing, no, proud, magnificent, wonderful, historic]
trust: [and, they]
trustworthy: [loyal]
truth: [and, the, and, I]
truthfully: [youre]
try: [to, every, to]
trying: [to, to, to, to, to, to, to, to]
tunnels: [and]
turns: [to]
two: [people, years, months, simple, planes, planes, simple, old, years, and, nucleararmed, centuries, countries]
tyranny: [Now]
ultimately: [rests, going]
unacceptable: [/1]
unaffordable: [Remember, It]
unbelievable: [-, success, And, tribute]
unbelievably: [at]
unchecked: [these]
under: [the, God, that, the]
undermine: [growth, our, these, our, your]
undermines: [democracy]
understand: [our, that, its, it, it, it, Theyre, that, what, -]
understandable: [by]
understands: [very, what]
undertake: [a]
unfair: [whats, So]
unflinching: [leadership]
unfreeze: [all]
uniform: [you]
uniforms: [like]
unify: [to]
unique: [histories]
unite: [us, to, our]
united: [states, together, against]
unlimited: [and, We]
unmatched: [in, Through]
until: [their, you]
up: [to, against, to, in, the, for, And, I, for, Im, here, Guy, Come, We, We, with, 1%, their, to, until, on, as, to, sandbags, and, Never, each, the, and, and, do, and, since, the, with, for, the]
uphold: [the]
upon: [these, a, us, the]
upÄwe: [ran]
urge: [Russia]
us: [Next, wrong, in, in, what, to, many, in, Isnt, Weve, We, and, to, to, to, to, Were, fairly, No, move, tonight, all, find, make, together, or, out, more, Afghanistan, The, against, with, today, all, that, who, together, the, that, all, By, down, We, and, on, on, all, Wheres, out, credit, because, But]
use: [it, American, hatred, some, of, this, it]
used: [against, the, to, to]
using: [our]
vacuum: [that, we]
value: [of, individual, the]
valued: [partner]
values: [and, and, and, and, We, to, then, will, of, traditions, and, are, And, that, are, that, as]
vast: [amounts]
vehicle‚ù: [that]
veins: [of]
very: [important, much, beautiful, short, clean, importantly, well, complex, happy, unfair, shortly, sad, well, nicely, very, sadly, very, highly, historic, simple, very, substantially, rich, much, much, complex, terrorists, much, much, nice, important, special, essence, first, very, beginning, strong, much, much, very, important, much, young, much, soon, impressive, interesting, successful, interesting, very, interesting, sad, young, sad, soon, much, special, very, special, special, importantly, much, much, much, much, much, proud, much, beautiful, specialÄNeil, honored, last, quickly, very, much]
vet: [those]
veteran: [replied, Were]
veterans: [have, Were, Our, have, are, We, Thank, Who, Were, and, grave, in]
vets: [We]
vibrant: [Jewish]
vice: [president]
vicious: [attack]
viciously: [murdering]
victory: [together, Nowhere, They, will, with, over, over, for, there]
vigilance: [and]
vigilant: [And]
vile: [vicious]
villages: [of]
violence: [against, and, and, against]
violent: [crime]
visit: [to, an]
vital: [and]
vitality: [and]
voices: [and, in, that]
volunteer: [for]
volunteered: [for]
volunteers: [who]
vote: [for, for, is, and, I, Shes, in, for, So, But]
voted: [for]
votes: [tomorrow, He]
wages: [Really]
waging: [battle]
wait: [and, us, a]
waited: [They]
waiting: [for]
wall: [Dont, We, I, And, in, and, And, which, no, to, But, We, wall]
walls: [a]
want: [any, to, to, to, to, to, to, safe, great, good, a, low, us, fair, lower, to, companies, to, a, a, to, to, to, to, to, to, people, people, people, people, people, that, the, to, to, to, to, this, to, to, them, them, God‚ù, them, them, to, to, to, to, to, to, to, to, to, to, to, to, to, to, to]
wanted: [it, to, it, to]
wants: [to]
war: [for, a, with, without, in, in, we, to, For]
warfighters: [that]
warmed: [every]
warmth: [and]
warning: [that]
warrior: [who]
warriors: [to]
wars: [that, We, together, abroad, that]
wartime: [commanders]
was: [from, this, the, asked, this, going, very, a, a, June, about, going, a, great, thanked, just, just, impossible, a, one, a, great, thrilled, taken, speaking, told, broadcast, actually, so, no, no, no, left, going, but, for, to, planned, ruled, given, getting, very, truly, reduced, one, crucially, critical, horrendous, the, several, so, soaked, the, never, kept, saved, an, a, the, very, in, very, paved, very, young, a, a, a, offered, a, a, now, very, the, one, a, doing, very, a, all, talking, the, happening, a, very, going, so, unbelievable, told., told, going, possible, more, Charlton, out, out, a, happening, in, a, hearing, some, the, an, proud, still, 3]
wasnt: [looking]
wasting: [your]
wasÄNovember: [.]
watch: [it, believe]
watched: [as, as]
watching: [So, from]
waver: [even]
waving: [to]
way: [youve, we, NAFTA, do, I, the, I, thats, a, outside, outside, they, that, we, whether, to, And, instead, or, of, of, where, he, Thank, are, And, what, all, just, theyre, to, to, do, under, do, Firemen, Boy, on, upÄwe, right, I, we]
ways: [A, even, and]
we: [have, need, allow, finally, will, have, sometimes, meant, always, are, cant, are, are, all, will, will, will, inherited, are, are, have, would, get, cant, have, believe, know, want, will, are, want, signed, do, did, were, had, will, all, were, dont, want, have, cant, will, talk, have, have, have, want, have, protect, chained, listen, will, can, as, all, all, open, send, are, send, will, ask, must, held, know, created, face, have, do, will, face, will, will, will, must, will, intend, are, will, will, are, want, will, lift, are, have, must, are, will, will, will, see, will, have, have, know, are, are, are, must, must, will, are, see, have, never, pledge, can, have, will, will, must, are, know, want, do, will, are, dont, just, debate, can, value, are, have, inherited, fail, cannot, will, know, will, stand, applaud, salute, applaud, have, have, have, do, will, will, put, cant, ought, have, leave, found, will, kept, love, have, can, could, remember, have, did, won, worked, go, go, had, going, won, did, are, are, know, know, can, know, love, read, say, are, were, knew, ended, have, want, are, were, have, will, want, did, have, wont, all, are, are, will]
weak: [and]
weaken: [our]
wealth: [They, of]
weapon: [to]
weapons: [and, anywhere]
wear: [uniforms, and]
weary: [of]
week: [I, I, on]
weeks: [a, ago, out, vile]
welcome: [stronger, new]
welcomed: [us]
welcoming: [our]
well: [one, right, have, And, know, with, be, for, as, ÄMore, be, be, be, on, so, not, at, at, wait, and, some]
went: [wasnt, out, personally, over, over, to, there, one]
were: [going, also, going, going, close, hundreds, clogging, going, going, possible, given, a, reacting, making, talking, countries, picked, not, put, going, all, going, left, going, going, going, going, supposed, supposed, supposed, injured, cut, occupied, determined, erased, invaded, preparing, supported, in, allowed, right, the, being, going, Scouts, Scouts, doing, doing, so, losing, at, at, putting, totally, all, saying, right, going, doing, with, with, very]
werent: [even]
west: [and, through]
weve: [accomplished, got, gotten, never, seen, raised, inherited, just, done]
what: [inspired, this, will, our, they, to, to, weve, they, theyre, You, did, they, he, it, it, I, happens, I, were, we, I, we, you, to, we, weve, matters, you, to, Ive, the, do, is, you, they, am, makes, makes, you, he, happened, was, to, we, we, we, youre, our, we, we, Its, theyre]
whatever: [I, is]
whats: [happening, happening, happening, going, happening, happening, wrong, happening, happening, happening, happening, happening, happening, happening, going, happening]
when: [American, they, it, the, I, they, some, other, they, one, they, you, youre, we, that, the, a, Im, they, Mike, they, you, the, youre, some, he, you, youre, you, youre, they, you, people, the, we, I, maybe, you]
where: [you, we, the, they, Republicans, we, we, we, street, are, they, they]
whether: [you, you, they, the, or]
which: [has, is, means, is, requires, are, will, make, they, Poland, good, threatens, the, I]
while: [Poland, ago, making]
white: [hats]
who: [would, want, love, salute, pray, are, makes, makes, are, are, protect, would, have, were, fought, serve, slaughter, target, threaten, we, have, lost, shed, know, have, seek, wish, have, have, have, they, you, share, reject, use, we, we, are, we, have, would, would, crossed, crossed, perished, died, the, will, made, are, were, was, was, you, Im, have, would, would, believe, has, are, threaten, used]
whoa": [But]
whole: [truth, big, and, East]
whom: [I]
whos: [going]
whose: [selflessness, tense]
why: [hed, we, were, shortly, we, my, we, we, are, I, do]
why‚ù: [he]
wicked: [system]
wide: [open, was]
wife: [said]
will: [be, put, never, never, never, be, hopefully, never, always, never, do, continue, continue, make, deliver, not, have, be, be, never, open, create, show, never, be, be, give, work, always, fight, start, do, pursue, be, come, We, be, make, make, make, make, always, find, be, win, stop, find, break, dry, defeat, defeat, learn, change, not, guide, not, Another, be, ever, continue, not, have, change, ensure, have, also, be, also, fight, fight, have, ask, Since, continue, have, secure, no, work, guide, not, work, keep, remain, make, never, honor, ensure, bring, push, Our, to, to, always, confront, win, always, always, prevail, undermine, undermine, to, never, never, never, never, not, never, know, Because, of, to, be, not, of, never, prevail, thrive, triumph, say, serve, serve, serve, serve, follow, be, be, tell, be, tell, say, have, gain, gain, create, contribute, be, be, live, win, have, become, inspire, help, be, never, federal, the, work, work, always, be, build]
wills: [and]
win: [win, win, We, America, the, We, anymore, at, in, anymore, -, Second, We, battles, We, From, But, freedom, Michigan, win, win, and, Because]
winning: [again]
wins: [and, big]
wish: [to]
with: [terrorismrelated, you, you, you, hard, no, the, it, it, those, our, you, the, people, that, our, it, women, you, women, a, I, I, big, that, bad, the, it, very, us, us, new, us, shrinking, community, us, one, itself, each, the, my, Pakistan, our, India, the, Afghanistan, real, a, additional, our, allies, the, any, power, the, the, you, the, true, names, countless, their, Pope, that, this, words, its, the, your, our, the, the, you, energy, being, the, your, that, teams, it, this, that, the, my, Iowa, 0., candidates, the, me, you, an, us, you, the, us, your, the, that]
withdraw: [from]
withdrawal: [would, We]
withdrew: [from]
within: [Let, our]
without: [the, Trump, victory]
woman: [and, named]
women: [always, care, You, We, We, in, of, of, we, we, who, and, and, and, as, of]
won: [wars, were, in, Poland, Florida, South, North, Pennsylvania, and, So, We, One, in, Wisconsin, the, the, for]
wonder: [theyre, theyre, if]
wonderful: [place, Not, First, to, Ronald, hunters]
wont: [show, have, show, go, get, get, give]
wood: [and, This]
word: [of, swamp, cesspool, sewer", momentum", momentum", you, momentum"]
words: [are, ÄMade, if, to, to, when, ÄWe, the, to, but, well, duty", In, basically]
work: [of, The, You, with, with, with, Its, And, with, and, effectively, quickly, with, with, together, and, Theres, You, then, So, 47, all, When, and, and, So, hard, hard, on, with, with]
worked: [together, hard, hard, hard, with]
workers: [in, win, You, Were, To, came, Youll]
workforce: [To]
working: [American, to, families, one, two, together, Because, You, really]
works: [of]
world: [is, but, and, but, Take, Were, Its, if, horrors, For, as, for, Thank, One, has, That, to, and]
worlds: [largest, greatest]
worried: [about, hes, about]
worry: [about, about]
worse: [because]
worst: [terrorist]
worth: [defending]
worthy: [of, of]
would: [take, say, have, have, have, rather, read, be, believe, create, instantly, soon, be, not, criticize, point, subvert, be, think, you, He, go, have, nominate, be, make]
wouldnt: [matter, say, believe]
wound: [inflicted, inflicted]
wounded: [warrior]
wow: [and]
write: [the, symphonies]
writings: [are]
written: [about]
wrong: [now, They, with, with, thing, But, correct, people]
wrote: [their]
yacht: [and]
yachts: [and]
yard: [when]
yards: [away‚ù]
year: [lobbying, youre, you, when, and, our]
years: [ago, after, They, late, late, and, let, ago, after, I, old, later, after, of, from, and, like, and, Michigan, by, The, Winners, ago]
yes: [its, its, we, Finally, I]
yesterday: [Thats]
yesterdays: [fights]
yet: [again, another]
you: [have, dont, try, keep, will, will, Governor, Nothing, But, are, down, God, God, very, Thank, Thank, everybody, I, thank, Its, This, Its, about, about, and, I, that, without, that, I, but, want, want, understand, understand, know, see, havent, everybody, think, know, believe, for, You, I, imagine, the, I, get, wont, get, but, whats, probably, have, can, have, can, were, can, could, could, know, and, read, watch, come, and, cant, look, wouldnt, know, see, veterans, in, didnt, can, want, can, in, And, and, Thank, Thank, very, very, Please, to, sit, the, are, Thank, May, very, Thank, very, Melania, My, Thank, Thank, On, have, Thank, Great, We, grow, along, This, have, never, oppress, or, you, endured, are, defend, were, Thank, This, never, but, are, came, won, have, know, see, know, Thank, Poland, the, set, We, have, God, God, Thank, very, everybody, very, think, have, amazing, as, And, for, mom, volunteer, are, are, learn, throughout, that, Ill, the, believe, here, They, very, very, what, Wheres, Secretary, going, their, have, look, will, that, learn, agree, think, know, And, people, so, I, can, also, face, will, never, discover, can, learn, want, must, love, If, dont, too, By, people, have, excited, want, love, do, will, have, a, what, Should, Youre, know, Who, like, doing", Youre, never, things, -, it, have, continue, dont, have, love, do, love, love, do, love, love, know, do, love, like, really, can, love, our, remember, remember, know, have, see, see, what, and, what, what, learn, pledge, go, gave, here, know, can, because, live, see, very, Thank, American, help, set, embark, who, are, hold, What, Boy, do, that, will, will, will, said, And, do, refuse, will, will, wear, love, This, God, very, very, Thank, very, Chris, very, very, very, know, remember, remember, know, know, go, know, and, again, -, But, came, I, not, do, helped, were, The, good, that, today, folks, by, both, of, heard, ban, now, know, need, need]
you": [And]
youll: [be, be, be, never, work, be]
young: [man, men, Polish, Scouts, patriots, Im, people, lives, then, there, And]
your: [home, President, support, agenda, demands, voices, children, loved, families, country, community, cities, taxes, service, families, nation, wonderful, country, security, place, economies, access, leadership, spirit, spirit, hearts, land, pride, countryside, great, noble, fight, faith, laws, history, identity, culture, humanity, cities, souls, life, dreams, dreams, lives, families, cities, country, former, lives, own, ability, own, teammates, passion, work, company, communities, nation, honor, best, duty, country, communities, lives, values, badge, scouting, path, duty, history, life, great, life, tremendous, taxes, healthcare, former, time, help, activism, Second, rights, freedoms, side, help, Attorney]
youre: [reading, making, President, wrong, fired", Boy, workers, talking, going, going, going, going, going, not, doing, not, not, forced, going, doing, pledging, going, not, going, going, already]
yourself: [Horrible, -, to, be]
yourselves: [and]
youth: [Were, Hes]
youve: [seen, seen, never, been, earned, done, done, done, been]
zero: [The]
zones: [in, Were, We, Theyve]
zoning: [and]
Ä: [a, theyre, come, this, yes, okay, okay, now, and, folks, you, and, no, think, Chopin, the, was, indeed, one, including, and, one, and, what, as, and, and, Europe, for]
ÄHe: [may‚ù]
ÄIf: [it]
ÄMad: [Dog]
ÄMade: [in]
ÄMore: [horrifying]
ÄThe: [far, mortally]
ÄThen: [why‚ù]
ÄThere: [is, is]
ÄTruth: [itself‚ù]
ÄWe: [Want, want]
ÄWhenever: [the]
ÄYoung: [man‚ù]
Äbecomes: [suspicious]
Äby: [proclamation]
Äfor: [such]
Änothing: [can]
Äwhat: [we]
